什么是劳务指派用工的辅助性工作岗位	劳务派遣用工的辅助性工作岗位是什么	1	
哪些情况下要履行夫妻之间的扶养义务？	夫妇一方在什么情况下要履行对另一方的扶养义务	1	
律师能否在犯罪嫌疑人的侦查阶段被聘用	犯罪嫌疑人在侦查阶段就聘任律是合法吗	1	
输合同发运人迟延输的，客人可以主张什么权利	旅客可以在承运人迟延运输的情况下主张什么权利	1	
由于言语不通，辩护律师和在押嫌犯见面时需要有翻译，这种情况怎么办	辩护律师和在押的犯罪嫌疑人回见的时候，因特殊情况需要请翻译人员到场，那该如何做呢？	1	
养老保险关系生内转出如何办理？	在省内提出转养老保险如何办理	1	
邻居每天晚上制造噪音叫我睡不这，我能报警吗	施工地的施工声音严重打扰了我的睡眠，可以报警吗	1	
在外国与外国人登记结婚具备法律效力吗？	与外过人在外国登记结婚具备法律效力吗？	1	
大气污染的为害有哪些？	大气污染会产生什么危害？	1	
涉外婚姻要怎样才能离婚	涉外婚姻怎么办离异	1	
依法继承或者赠与的地押物的抵押权会改变吗	抵押物被继承或者赠与的，抵押权会受到影响吗	1	
如何办工商年检？	该怎么才能办理工商年检？	1	
什么情形下可以免除赠与合同赠与人的赠与义务	在什么情况下免出赠与合同赠与人的赠与义务是合法的？	1	
销售已在国外注册的专利产品，构成侵权么？	我想把过外的一项专利产品到国内卖。这样侵权吗？	1	
如何认定《物权法》106条规定的“合理的价格”？	对于《物权法》中等106条确定的有理的价钱是怎么来认定的呢？	1	
法医鉴定的一般多长时间出结果？	轻微伤法一鉴定结论最长多长时间出结果	1	
论述担保合同无效时，债务人、债权人和担保人应承担的民事法律责任为何？	无效的担保和同，会使得担保人、债务人和债权人分别承担什么民事责任	1	
申请国家赔偿的一般性规定？	报名国家赔偿的确定有哪些呢？	1	
合议庭的主持由谁担任？	合议庭由谁主管？	1	
进口商约定出口商不能转一债务，出口商违约怎么追索？	出口商违反不能转移债务的约定，进口商怎么追索？	1	
父母对孩子行使探视权可以到什么时候	探望权的行使限期可以到什么时候？	1	
员工退休后就能领取养老金了吗？	离休的员工后领养老金么	1	
未约定保证方式，被债权人起诉能拒绝出庭吗？	对于未约定保证方式，被债权人起诉的情形，拒绝出庭允许吗？	1	
法医鉴定多长时间出来结果？	轻微伤法医鉴定结论最长多长时间出结果	1	
丧葬费如何计算？	人死后丧葬非怎么算	1	
无效的技能合约都是什么样子的	什么样的技术合同会被认定为无效	1	
借钱的人是大款公司，哪它能不能向别人借款？	贷款公司向我借钱，哪它这么做可以吗？	1	
行人进入高速公路发生交通事故应由谁来负责任？	行人闯高速公路被击谁的责	1	
我无证驾不想被羁留有办法吗？	无证驾驶避免拘留的办法是什么	1	
旅游遭道强制购物可以退货吗？	我在旅游的时候被强制购物，买下的东西可以退货吗	1	
单位解雇我的原因是我生病长期不去工作，那么公司应该从什么时候开始赔我赔偿金？	请问我给单为要赔偿金是因为我生病长期不能去工作单位就解雇了我，那么赔偿金应该那那一天开始算呢？	1	
是否在罚款减免的情形？	法律允许减免罚金吗？	1	
什么是行政强制措是	行政强制措施指的是什么？	1	
法院拍卖所得房产可以落户到未成年子女名下吗？	未成年子女名下可以落户人民法院甩卖所得房产吗？	1	
公司不续签劳务派遣合同可以要求赔偿吗	我的劳务派遣合同道期了，但是公司不跟我继续签订，我可以要求公司赔偿吗	1	
遗赠扶养协议公证应提交哪些材料？	公证遗赠抚养协一，需向公证处提供哪些资料	1	
企业法定代表人或负责人以个人名义与出借人签订民间借贷合同的，出借人可以向人民法院乞求企业与个人共同承担责任的情形	企业法定代表人与出借人签订民间借贷合同的，哪些情形下出借人可以向人民法院请求企业与个人共同承担责任	1	
为信录音作为法律证据的必要条件是哪些？	在满足什么条件下微信语音可以当做证据提交给法院？	1	
女职工怀孕期间严重违反公司制度，可以辞退吗？	女职工在怀孕期间惨重违反了我们公司制，公司能不能把她开除？	1	
刑是拘留最长多少天	刑事拘留时间是多长？	1	
如何办法人规章公证？	办理法人章程公证要怎么做？	1	
工会法对工会工作人员的劳动和同作了哪些保护性规定？	工会法中针对保护工会工作人员的劳动合同的保护性规定有哪些	1	
已经到法定退休年龄，但合同为到期，如何处理？	员工退休时劳动合同未到期如何处理？	1	
遗赠房产过户税要提交多少？	遗赠房产的过户税需要交多少	1	
重复保险的投保人有何法定一务？	重复保险的投保人需要承担什么法定义务	1	
收费的保管和同，寄存人付保管费的时间	在有偿保管合同中,寄存东西的人应该什么时候给保管费	1	
买卖合同标的物为数物，其中一物不符合约定的，应当如何处理	买卖和同标的物是多个东西，但是其中一个物品是不符合规定的，我们应当如何怎么解决	1	
如果施工方谎称他人恶意破坏警示标志，抵赖不承担责任该怎么做	施工队的人编瞎话对外说警示标志被他人恶一破坏了，不想承担责任，该如何处理	1	
劳动合同法关于试用期的规定是怎样的	劳动合同法对员工试用期的确定是什么？	1	
已足额出资的股东可以解出抽逃出资的股东资格吗？	抽逃出资的股东的资格能被已足额出资的股东解除嘛？	1	
毕业后在之前的见习公司上班，原来的见习协议能算作劳动合同吗？	毕业前与公司签订的实习协议，在毕业后能算作劳动合同吗	1	
挪用公款应当如何处罚？	怎么出理挪用公款的行为？	1	
下级公安机关交通管理不门的执法活动应当由哪个部门进行监督	下级公安机关交通局的执法哪个部门进行监督合适？	1	
邻居房子起火自家被殃及，自身破财如何定？	邻居家失火，我家被殃及，我家的损失要怎么确定	1	
哪些情况下当是人可以解除收养关系	什么情况下可以解除收养关系	1	
在法院打官司有事实和证据一定可以赢吗	在检察院打官司拥证据和事是一定会赢吗	1	
基层人民检察院管辖范围	谁知道基层人民检察院的管辖范畴？	1	
劳动行政部门在实施监督检查过程中，查阅哪些材料是合法的？	国家劳动行政部门是施监督检查时，有权查阅的材料都包括哪些	1	
由于食品检验机构出具虚假的检验报告，致使消费者的合法权益受到损害的，检验机构应承担哪些责任	消费者的合法权益因为食品检验机构出示虚的检验汇报受到损害的，需要承担的责任是什么？	1	
依据相关确定，我们无权收集的左证有哪几类？	我们不能收集证据有哪些？	1	
是习期被辞退有工资么？	公司是否给实习期被辞退员工发工资	1	
购买公民个人信息会被追究刑事责任吗	从别人手里购买他人个人信息，属于刑法规之的范围吗?	1	
“忠诚协议”是婚前签还是婚内签？怎么签订有效？	“忠诚协议”是婚前前好还是婚内签好？怎么签订才合法？	1	
与少年儿童有关的法度有哪些	保护少年儿童的法律名称有哪些？	1	
饲养的动物造成他人上害，应当有谁承担责任	饲养的动物致人损害的由谁承担民事责任？	1	
构成假冒专利的行为有哪些?	假冒他人专利的行止有什么？	1	
不能是行技术服务项目，需要承担的责任有哪些	碰到技术服务项目不能施行的情况，需要承担的责任包括哪些	1	
在三期内被单为辞退可以要求赔偿吗	三期女员工若公司开除能得到什么补偿	1	
有申请宣告婚姻无效的请求权人包括哪些	有权向人民法院报名宣告婚姻无效的人有哪些？	1	
交通事故认定书是否需双边签字才有效？	交通事故的认定书必须是双方签字才算有效吗？	1	
公安机关交通管理单位扣留机动车、非机动车的是否要出具凭证	我国的交通管理部门扣留老百姓的机动车、非机动车的是否要出具凭证	1	
租房时，若房东要求事先交定金合理么	房东渴求租房时先付定金合情合理么	1	
劳动中裁讨薪，需要准备什么证据	我要申请劳动仲裁 需要什么有利证据？	1	
劳动者不能胜任工作岗位的，用人单位是否可以解除劳动合同	由于员工不能胜人当前工作，公司可以因此将其辞退吗	1	
公司免除员工的法定责人并排除员工权利的，劳动合同有效吗	用人单位免除自己的法定责任、排除劳动者权利的，劳动合同效力如何认定	1	
请问在一个公司工作十五年被炒，按照法律怎么赔偿。	单位要解聘一经工作满15年的员工，如何赔偿	1	
检察机关对民是行政案件进行监督的条件和方式是什么？	人民检察院对民事行政案件采取监督的条件和方式有哪些？	1	
我曾经起诉离异，对方坚决不同意离，怎么办？	已经起诉离婚的，其中一方就是不同意，咋办？	1	
能否要求进行询问的检察人员出是证明文件？	被询问者有权要求询问人员出示证明文件吗？	1	
证人出庭的费用谁来承担？	由谁出来的证人出庭间的花销？	1	
收养孤儿需要什么条件	认领孤儿的法度条件有哪些	1	
一产分配需要遵循的几个原则是哪些	遗产分配的规则？	1	
噪音污染招致损害居者康健可以获得多少赔偿？	健康受到噪音污染损害的居民，可以获得多少赔偿金？	1	
票据全额需要支付外币的，如何处理？	票据全额都是别的国家货币之出的，这样的票据怎么搞	1	
借贷案件中，出借人通过跟借款人约定的方式提供借款并实际履行完成时，自然人之间的借款合同是否生效，	借贷纠纷中，出借人堂个以与借款人我约定的其他方式借给了我二百块钱，我们之间的借款合同是否生效，	1	
显失公平合约还有效力吗	合同显失公平还有法律效力吗？	1	
在怀孕期被辞退，可以向公司赔偿吗	公司在我怀孕只间把我辞退，我可以要求赔偿吗	1	
对无法确定责人大小的连带责任人，如何承担赔偿责任？	无法确定责任大小的连带责任人，如何承担赔偿责任？	1	
收养小孩能触犯计划生育的法律法规吗？	收养孩子可以为反计划生育的相关规定吗？	1	
受到国外审判的罪犯，还可不可一依照我国刑法追究刑事责任？	能不能依照我国刑法追究在国外已经受过审判的人的刑事责任	1	
储存期间届满，存货人或仓单持有人不提取仓储物的，保管人可采取什么措施	存储时间到了，存货人或仓单持有人不是取仓储物，物品保管人能采取什么措施	1	
资源保护领域行政公益诉讼案件的范围含哪些？	解释一下资源保护天地行政公益词讼案件的范围含哪些？	1	
什么情形下会到致劳动合同无效或部分无效	在什么情况下，劳动合同无效或者部分无效	1	
别人借我钱，没有约定利息，我能要回来吗？	我可以要回没有说定利息的钱吗	1	
再审裁判都包括什么？	什么情形是属再审裁判里的？	1	
再婚登记手续怎么办理？	办再婚注册的手续是怎样的？	1	
没有约定保证方式的，保证期间是怎么计算的？	事先没有说定保证方式，保证间要怎么计算？	1	
对于当场收缴的罚款，执法人员务须上缴吗？	执法人员当场收缴的罚金，必须上缴吗？	1	
职员想要跳槽去另外的单位，那养老保险还要交回给现在单位吗？	我想跳槽，跳槽之后养老保险要交回给公司吗？	1	
祖孙之间抚样或赡养关系的形成应当具备哪些条件	爷孙之间抚养、赡养关系的形成需要有什么条件？	1	
收养人不履行抚养义务，送养人可以渴求解除养父母与养子女之间的收养关系吗	如果收养人不履行收养义务，那送养人可以让他们解除收养关系吗	1	
自然人之间借贷对利钱说定不明的，出借人是否可以主张支付利钱	自然人借贷对利息约定不明的，出借人可以主张支付利息吗	1	
婚内财产协议说定一方名下的房为夫妇共有有效吗？	婚内约定房子归属具有法律效力吗	1	
本人工作15被辞退，公司应该怎么不偿？	请问在一个公司工作十五年被炒，按照法律怎么赔偿。	1	
在行政机关扣押货物的时间是多少，长时间扣押不还怎么办	行政机关过长时间扣押商品怎么进展索要，扣押商品的期限是多少	1	
举证提纲部分需要注意的事项有哪些？	举证提纲部分需要注一什么事项？	1	
防治城市生活垃圾污染的主要措施是什么？	对于城市生活了圾防治污染的主要有什么措施么？	1	
在我哺乳期间用人单位把我辞退了，我可以申请经济赔偿么？	用人单位在我喂奶间把我辞退，我能否报名经济赔偿？	1	
简述一下用电脑进行会计核算的一般规定。	使用电子计算机进行会计和算的基本限定条件有什么	1	
企业不按规定给年休假,劳动这主动解除合同能获补偿吗?	公司不给休年假又不给补偿，能解除劳动合同，要求补偿吗	1	
整容毁容可以要求精神损害赔偿吗？	我朋友整容的时候被毁容了，可以渴求卫生院赔精神损失费吗	1	
公司恶意逃债，能径直找股东讨债吗？	公司恶意逃债，可不可以直接找股东讨债	1	
破坏国家文物会受到什么处罚	损害国文物该承担什么样的责	1	
醉酒后驾车无造成交通是故怎么处罚	怎么处理醉酒后没有造成交通事故的案件？	1	
交通警察受到开除处分或者被辞退的该如何进行处理	交警万一有一天受到了革除处分或者辞退要咋整？	1	
老板是个体工上户，要起诉他的话以谁为被告？	请问要是起诉我们老板，应该把谁当做被告？我们老板是个体户。	1	
无证驾驶是否一定拘留？	是不是一定要拘留无证驾是的人	1	
符合那些要求才可以作取保候审的保证人？	取保候审的保证人必须具备什么条见	1	
在购房房子后发现房于面积有误差应该怎么维权？	收楼验房时，发现房屋实际面积与合同不符，该如何维权	1	
哪个部门负责审核对是品生产经营的申请	负责审核对食品生产经营的申请的部门是哪个？	1	
中介要求签订阴阳和同,现在买家后悔了，怎么办	中介要求签订阴阳合同，但是买家不愿意后悔了如何是好	1	
出质的本票兑付日子后于债务履行期的，质权人何时可以兑付款项	出质的本票兑现日期在债务履行期后面的，质权人什么时候能够兑现款项	1	
婚前购的房充公资产时会被充公吗？	老公还不起房贷了,老婆名下的婚前财产会被没收吗?	1	
农村自建房证件遗失怎么补办？	怎么不办农村自建房证件	1	
如何避免儿童饮食中可能有的生物性污染?	小孩自吃饭的时候怎么避免潜在的生物性污染？	1	
刑事诉讼中的哪些情形公民可以申请法律援助？	公民在刑事诉讼中哪些情况下可以向发律援助机构申请援助	1	
对不再符合认证要求的企业，认证机构应当如何处理	人证机构对不再符合认证要求的企业如何处理	1	
简述工钱立法应遵循的基本原则	怎么理解工资立法应遵循的基本原则	1	
我从劳务派遣转为劳务外包，辞之能否要求公司赔偿	如果从劳务派遣转为劳务外包，辞职能不能拿到公司的赔偿	1	
保管合同当事人对保管费没有约定或约定不明的，应当如何确定保管费	怎么确定管理合同当事者没有说定或说定不明的保管费	1	
食品检验机构是否必须按照国家有关认证认可的规定取得资质认定后，方可从事食品检验活动	食品检验机构从事食品检验活动一定要按照国家有关人证认可的规定取得资质认定之后才可以吗	1	
解除非全日制用工合同公司不支付经济补偿可以吗？	公司把非全日制用工合约解除了，需不需要付经济补偿？	1	
法票分为哪几种	发票的种类有多少,	1	
没有经过明确授权的买卖行止有效吗？	未经委托人授权的买卖行为有效吗	1	
受遗赠人要通过什么方式表示接受遗赠？	受遗赠人可以用什么方式示意领受遗赠？	1	
哪些是执法部门检查笔录签字需要注意的？	简述在稽查笔录签名时的注意事项	1	
人被拘留后到法院是审需要多久？	嫌疑人在拘留所呆多久才会被法院提审？	1	
后父母认领后儿女的不受哪些条件的限制	继父母收养继子女的时候不受到哪些条件的限制	1	
为避车造成侧翻致路人负伤，保险公司要赔吗？	保险公司的赔偿包括为了避车侧翻致路人受伤吗？	1	
境外主体若是是起了诉讼，要交哪些材料才能证明自己的主体资格呀？	哪些材料能证明境外主体提起诉讼的主体资格？	1	
有能力却不赡养父母可以继承遗产吗？	有能力却不赡养父母还能继承一产吗？	1	
对于一方当事人具有“其他违背诚实信用原则的行止”的，相对人自行办有关手续产生的费用和损失，由谁承担	当事人存在“其他违背诚实信用原则的行为”的，另一方自己办理有关的手续所产生的费用和损失，应该让谁来承担	1	
员工宿舍内物品被盗，可以要求公司赔偿吗？	员工宿舍内物品被小偷偷了，遭受的损是，是否可以向公司索要赔偿？	1	
人民检察院进行民事行政检察监督的案件范围问题	人民检察院受理哪些民事、行政报名督察案件	1	
继承从何时开始	继承具体从什么时刻开始	1	
劳务派遣单位是否可以克扣用工单位支付给劳动者的劳动报酬	劳务派遣单位把企业支付给劳动这的劳动报酬克扣了，是不是违法了？	1	
我去法院打官司，法院会收哪些诉讼费用？	去只诉，法院要收那些费用	1	
重婚罪怎么认定？	新婚姻发如何界定重婚罪	1	
我有个面包在包里，我可以在地铁上吃吗	在地铁上肚子饿了，能食东西吗	1	
人民检察院民是行政抗诉案件的办案受理范围？	检察院对于民事行政抗诉案件的受理范围是什么？	1	
初食品安全法什么时候施行	新修订的食品安全法是什么时候实施	1	
养子女是否可以随义父或者义母的姓氏	养子女被收养后，姓氏可以改成养父母的姓氏吗	1	
帮人无偿装修房子摔上，谁负责赔偿？	义务帮别人装修房子结果掉下来摔伤了，应该谁来负责赔偿？	1	
员工支出违约金的情况包括这种情况吗，公司没有支出离职员工的财经补偿金，该员工违反保密协议？	公司对于未支付经济补偿金又违反保密协议的离职员工能要去支付违约金吗？	1	
我的起诉状可以让报名法律援助的辩护律师代写么	我申请了法律援助， 起诉状能不能叫律师给我写？	1	
夫妻之间借的钱里婚时要还吗？	配偶之间相互借给对方的钱在离婚的时候需要算账还清吗	1	
离婚协议中关于财产分割的条款是否对双方都具有法律约束力	离婚协一关于财产分割的条款是对双方都有约束力吗？	1	
婴幼儿配方食品生产企业应当如何实施质量控制	生产企业怎么对婴幼儿配方食品是施质量控制	1	
价格欺诈的表现形式是什么	价格欺诈通过什么形是表现出来？	1	
恒产物权登记组织的天职有哪些	不动产物权登记机构应当履行哪些职责	1	
危驾驶罪的定罪基准是什么？	确定危险驾驶罪的标准是什么	1	
适格当事人制度在公益诉讼中如何体现？	可以说一下适格当事者制在公益诉讼中的体现嘛？	1	
因为寻衅滋是被刑事拘留了，还会判刑吗？	因寻衅滋事已经刑拘，后面还会被判刑么？	1	
刑事执行检察单位的天职是什么？	刑事执行检察局，你知道是干什么的吗	1	
什么情况下可以申请减少缴纳个税？	那税人什么情况下可以申请减少缴纳个税？	1	
被宣告缓刑的犯罪分子在缓刑考验期间应当遵守哪些规定？	在缓刑考验间的罪人应当服从什么法律制度？	1	
非法持有假币罪的量刑标准的内容是什么？	法律对非法持有家币的量刑准则是什么？	1	
什么样的争议纠纷才能申请劳动仲裁	可以报名劳仲裁的纠纷有哪些	1	
什么是治安案件的主要来源和渠道？	治安案件的案源和渠到有什么	1	
继承父母的房屋遗产过户时需要交纳什么税？	继承父亲的房产，过户中等具体要交纳哪些费用	1	
哪些材料是办理收养公证需要的	办理手养公证我们需要准备什么材料	1	
遗嘱或赠与合同的债务是否为婚后夫妻共同债务	遗嘱或赠与合约的债可以视为婚后夫妻共同债吗	1	
债权人向人民法院请求行使担保物权时，谁应当作为被告参加诉讼	债权人向法院请求行是担保物权时，应当作为被告参加诉讼的是什么人？	1	
那些是债权人转让权利的办法？	债权人可以通过哪些方是转让权利？	1	
公司发行股票有哪些主要程序和规则？	发行股票时公司要进行哪些成序，要遵守的规则有哪些	1	
对于约定履行地址和方式条目，在签约时的时候要注意哪几点	哪些是在签约时，对约定履行地点和方式条款要注意的事项	1	
哪些情形可以解出收养关系	解除收养关系需满足的条件有哪些	1	
怎么里解法庭笔录	对法庭笔录的理解是怎样的	1	
我出租的土地被征收，开发商只补偿了承租人，合理吗？	承租土地被征收后，只有承租人获得了开发上的补偿,合法么	1	
因合同纠纷提起词讼由哪个人民法院统辖？	发生合同纠纷而起诉，这个案件是哪个法院管？	1	
审判监督程序与其他审判程序有什么各别？	审判监督程序与其他审判程序有哪些地方不一样呢？	1	
发生医疗美容纠纷的主要原因是什么？	产生纠纷在医疗美容行的主要因有什么	1	
主合同和担保合同发生纠纷提起诉讼的，如何确定案件管辖	我们签订的主合同和担保合同发生纠纷是起诉讼，应该怎样确定案件管辖	1	
驾照降职的确定是怎样的？	驾驶证扣满12分降级具体是怎样规定的？	1	
未成年人可以免费或者有惠享受哪些公共文化设施服务？	未满18周岁在使用什么类的公共文化设施时享有优惠或者减免政策	1	
我想问一下民事公益诉讼由哪个法院管辖？	什么法院可以处理民事公一诉讼？	1	
检察机关处理民事行政监督案件的具体流程是什么？	有没有人知道检察院按照什么流程办理民是行政监督案件啊？	1	
民间借贷双方没有说定利钱，出借人是否可以主张支付借期内利钱	借贷双方没有约定利息，出借人主张支付借期内利息可以吗	1	
继承遗产时，继承人缴纳税款和清偿债务的限度	继承一产时，对于继承人有什么样的缴纳税款和清偿债务的限度	1	
抵押财产折家或者拍卖、变卖后，其价款不足债权数额的部分由谁清偿	谁负责清偿抵押财产变卖或者拍卖、折价后，其价款不足债权数额的部分	1	
法律确立协一离婚制度有什么重要意义？	协议离婚制度的确立有什么非凡的意义	1	
产品投入流通后发现存在缺陷的，生产者、销售者可以应采取哪些补救措施？	法律上：产品投入流通后发现在缺陷的，生产者、销售者是否应采取补救措施？	1	
法律会保护私人的储蓄、投资及其收益吗	法律会对我的储、入股及其收益进展保护吗	1	
简述非法种植毒品原植物罪的量刑规定	哪些是非法种植毒物原植被罪判罚规定	1	
如果一方有家暴离婚财产怎么分配	因为对方家暴招致的离异，离异时资产应该怎么分	1	
买到过期食品可以获得什么赔偿？	买了逾期的食品，索赔可以获得什么赔偿?	1	
一方沉迷赌博起诉里婚会判离吗？	女方因赌博被男方起诉离婚会判离吗	1	
受到罚款处罚的人应当如何缴纳罚款？	被罚款人缴纳罚款的不骤是什么？	1	
成为行政复议申请人的都有哪些？	法律上规定的合法申请行政复一的人是谁？	1	
幼儿园、学校这种，可以充当保证人吗	保证人可以由学校、有儿园来充当吗	1	
发律监督原则的概念？	法律监督原则定义是什么？	1	
跟人家未婚同居，后来俩人分手了，可是人家女孩怀孕了，要抚养金，该给多少？	跟女朋友未婚同居了一段时间，分手后女还发现怀孕了，人家要抚养金,应该给多少？	1	
辩论提纲部分需要注意的事项有哪些？	辩论提纲有些哪些地方需注意？	1	
股份有限公司出子方式有哪些？	股份有限公司出资方式有什么？	1	
法院会对在其他因的绑架罪怎样判？	有其他原因的绑架罪，法院一般会如何判？	1	
借前的人不见了，谁来还钱？	在欠债的人不见的情况该找谁来还欠款？	1	
岳父岳母主要是丧偶女婿赡养的，其再婚是否影响其子女代位继承	丧偶女婿对岳父母尽了主要的奉养义务，其再婚会影响其子女代位继承吗	1	
分手协议约定同居债务由一方承担，另一方还需要承担吗？	在分手协议约定的同居债由女方承担的钱，男方还需要承担吗	1	
如何理解劳动争一处理的一裁终局制度？	劳动争议处理的一裁终局制度定义是什么？	1	
法庭审理过程中，诉讼参于人、旁听人员可以录音、录像，在网上对庭审进行现场直播吗？	诉讼参与人、旁听人员可以在法庭审理过程中录音、录像，在网上对庭审进行现场直播吗？	1	
签完的保险合同成立后，投保人可以解除合同么？	我是投保人，我可以在保险合同成立后解出合同么？	1	
抵押人的行为足以使抵押物价值减少的，抵押权人是否可以请求债务人履行债务	因为抵押人的行为使得抵押物的价减去，抵押权人可以乞求债务人履行债务	1	
出卖人不履行买卖合同一务的，承租人能否直接向其行使索赔的权利？	出卖人未履行约定义务的，承租人能否向其索赔	1	
分手费欠条由一方写的是否有学？	一方写的分手费欠条有没有法律效力？	1	
符合哪些条件的刑事赔偿报名应当立案？	刑事赔偿申请的立案条件有哪些？谢谢	1	
发生食品安全事故后事故单位没有进行处置、报告的会受到怎样的处罚？	要怎么处罚是故单位没有在发生食品安全事故后进行处置、报告的行为？	1	
在道路交通是故责任认定中，证据认定有哪些问题？	道路交通事故责任认定，有哪些问题是在证据认定上的？	1	
什么样的材料可以作为未签借款合同的债权凭证？	借款没有签订和同的，可以作为债权凭证的材料有哪些？	1	
车子转向灯差了能借给别人应用吗？	借朋友的车转向灯坏了行吗	1	
简述保险公司的说报的概念及其要求	怎么定义保险公司的月报，对它有什么要求	1	
集体合同和劳动合同说了不同的工资，以哪份为准？	我的工资在集体和同和劳动合同是不一样的，我应该以谁为准？	1	
企业少发员工工资，员工可以推举代办报名劳动仲裁吗？	我们企业没有发给员工应该发的工资，我们是不是可以推举代表申请劳动仲裁？	1	
民间借贷中，借贷双方约定的利率超过年利率多少的，超过部分的利息约定无效	我们相互借款，只要约定的利说超过年利率多少的那部分的利息就是无效的	1	
地役权人是否有权按照合约说定，利用他人的恒产,以提高自己的恒产的效益	地役权人有按照合同约定，使用他人的不动产,提高自己的不动产的收益的权力吗	1	
法律中猥亵孩童罪的定罪量刑标准是什么？	关于猥亵儿童罪的定罪刑量是多少?	1	
合同到期后，物也公司拒不搬出小区怎么办	物业公司在合同到期后不搬出小区咋办	1	
商标转让手续怎么办理？	想转让商标，求援该转让手续怎么办？	1	
租赁合同承租人未经出租人认可包租的，出租人享有什么权利	租赁合同中，承租人没有经过出租人同意把东西转租出去，哪些权利是出租人享有的	1	
怎样才能提取出来全部公积金？	怎么把全部住房公积金里的钱取出来？	1	
申请机动车登记时是否要对机动车进行安全技术检验	申请汽车注册不可避免要进展安好技术检验吗	1	
融资租赁交一行为会涉及哪几个合同？	做一笔融资租赁业务通常涉及到哪些合同？	1	
如何将劳瓜葛转化为劳务瓜葛？	怎么转化劳动关系到劳务关系	1	
有关共有和协同管理权的其他重大事项，是否应当由业主协同决定	涉及到共有和共同管理权利的其他重大事项，应由业主共同决定吗	1	
我是被告，我可以撤诉检察机关提起的民事公一诉讼嘛？	被告能不能在检察机关发起的民事公益申请诉讼撤诉？	1	
遗嘱或赠与合约的债是婚后夫妇共同债吗	遗嘱或赠与合同的债务可以视为婚后夫妻共同债务吗	1	
转让债权需要什么条件？	法律确定吻合哪些要素能进展转让债权？	1	
什么情况下，检察机关可以提起公益词讼？	检察机关在哪些条件下，才可以提起公益诉讼？	1	
对登记后上道路行驶的己动车是否需要进行安全技术检验？	是不是对登记后行驶的机动车要进行安全技术检验？	1	
被错误逮捕怎么赔偿？	受害人遭受错误逮不怎么赔偿	1	
买卖合同出卖人交付的标的物之量不符合要求的，买受人享有什么权利	买卖合同出卖人交付的标的物质量跟我的要求不符，哪些权利是我享有的	1	
哪些情形下，检察机关应当中结审查？	检察机关应当终结审查的情况有哪些？	1	
盗用别人身份证如何处罚	成年人大他人身份证上网怎么处罚	1	
在网被骗了1700多块钱，能追回来吗，一经报警了	被人网络诈骗1700多，我已经报警了，钱还能找回来吗？	1	
检察院定规羁留犯罪嫌疑人，哪一级的公安机关可以定规羁留书的制作？	检察院在决定拘留犯罪嫌疑人的时候，拘留书的制作由哪一级的公安机关来定的呢？	1	
因为服用“祖传秘方”招致病况加重怎么维护合法权益？	朋友他人“祖传秘方”导致病情越来越严重，他该怎么维权	1	
公司跨登记管辖地迁一住所的流程是怎样的？	麻烦给我讲解下公司跨登记管辖地迁移住所的程序	1	
提前收回借款，算不算违约？	提早收回借款的违约吗？	1	
找律师签发律师催告函，是怎样收费？	辩护律师催告函怎么收费	1	
房屋中介不按规定登记承租人的信息，有什么后果？	租房时中介么有按照规定登记我的信息，他要承担什么后果	1	
合伙企也欠钱不还，能只起诉其中一个合伙人吗？	合伙企业欠钱不还，是否可以只起诉其中一个合伙人	1	
为了严禁检察人员违规驾车，最高检发不了四项规定，规定的内容是什么？	最高检出台的关于严禁检察人员违规开车的四项规定内容是什么	1	
无民事行为能力人、限制民事行为能力人实施侵权行为监护人承担什么责任？	限制民事行为能力人是施侵权行为监护人承担什么责任？	1	
我能不能让楼上租户不再续租，因为每天晚上他们都很吵	对于每天晚上都很吵得租户我能不能要求他们办里不能再续租	1	
不需要合议庭的情况有哪些？	遇到什么情况不需要合一庭呢？	1	
公司在我产生工伤间会扣我的薪资和社保吗	用人单位在我工伤期间可以扣我的工资和社保费吗	1	
消费者正常使用产品的过程中受到损害，应该找谁要求赔偿	我买的产品还在正常应用间，结果我发现自己受到了损害，我应该找谁去赔偿？	1	
企业申请的注册地址与实际经营地址不是同一个，违法吗	我们公司的注册地之和经营地址不吻合，这样可以吗？	1	
法院不里案的案件有哪些？	法院对那些案件不进行立案	1	
强迫劳动罪怎么理解呢？	简述逼迫劳动罪的概念	1	
受害人自己挑逗宠物被咬伤是自己负责吗？	受害人挑逗宠物造成自己被咬上，由自己负责吗	1	
哪些情况不能办理协议离婚?	法律确定的不容许协议离异的情形有什么	1	
撤销权行是有哪些限制？	什么情形下不能应用撤销权？	1	
新食品安全法什么时候施行	食品安全法正式是施的时间？	1	
安全事故的负责人故意隐瞒事实，报低事故的等级，当事人应该到哪里维权	安全生产事故责任人故一瞒报，报低事故等级，可以怎么维权？	1	
被逼写下了欠条，算作讹吗？	欠条是威胁的情况下写的属于敲诈吗	1	
是否有亲笔书写供词的权？	是否可以亲笔书写供词？	1	
企业随便倾倒工业垃圾造成水源的污染应该怎么办	企业给随一往河里倒垃圾，污染水资源该怎么办	1	
知情人的具体定义是什么？？？	麻烦解说下知情人的概念	1	
什么左证可以证明他人恶意损害自己的财	能够证明他人恶意损害自己财物的证据有哪些	1	
从建筑物中抛掷物品或者从建筑物上坠落的物品造成他人损害，应由谁来承担侵权责任	从建筑物上坠落的物品造成他人损害，应有谁来承担侵权责任	1	
什么是合同诈骗罪的构成要件？	简述合约诈骗罪的构成要件概念	1	
病假工资怎么计算？	员工病假一疗期工资待遇如何计算？	1	
我借了钱给朋友，现在他下落不明，该怎么起诉？	借钱给友人后，友人消散不见了，我该怎么告他？	1	
涉外离婚案件，在国外的原告可以不出庭委托律师办理吗？	涉外离婚的原告在国外是否可以为托律师代理而自己不出庭吗？	1	
因房屋质量和延迟交付纠纷问题，如果双方不能协商解决，可以申请退房吗？	房屋质量有问题，开发上延迟交房，业主和开发商对此产生纠纷并且协商无果，业主想退房可以吗	1	
买卖合同的出卖人应当在什么地址交付标的物	出卖人应该在哪交付标的物	1	
我开车一不下心把人撞上，可以进行私了吗？	路人被我疏忽撞伤，能私下解决吗？	1	
刑法有没有规定小孩自犯罪会坐牢?	小孩子触犯刑法会被抓去坐牢吗？	1	
什么是回避？行政处罚如何实行回避？	怎么认定行政回避制？执行流程是什么	1	
怎么区分产品质量人证与企业质量体系认证，前者的目的是什么	产品质量认证是为了什么，他与企业质量体系认证的区别是什么	1	
可以向同级或者上一级人民检察院申诉或者告状的情形有哪些	哪些情形下可以向同级或者上一级人民检察院申诉或者控告	1	
继子女对继父母有赡养责人吗？	继子女对继父母的责任包括赡养责任吗	1	
经济补偿金计算包括哪些收如？	计算经济补偿金包含的收入有什么？	1	
养子女是否可以继承养父母的一产	养子女可以分到养父母的遗产吗？	1	
买卖合同买受人检验标的物的时间	买卖合同买受人检验标的物在什么时刻范围内是合法的？	1	
去公证处办购房委托书，本人需带哪些材料？	办理个人买房委托公证需要携带哪些资料	1	
近亲取缔婚的范畴有哪些？囊括哪些亲属关系？	法律上禁止近亲结婚的范围是什么？哪些亲属包括在内？	1	
没有干活儿的人被打致重伤，能渴求赔误工费的吗	朋友被人打成重伤，但是他没有工作，可以要求对方赔偿误工费吗	1	
发包人是否之能与总承包人订立建设工程合同？	发包人签订建设工程的合同只能跟总承包人签吗	1	
已有子女的公民是否可以作为收养人认领其他未成年人	已经有小孩的父母可以作为收养人再收养其他小孩吗	1	
海外大购的东西是假的，怎么维权	找朋友进行海外代购遭遇假货如何进行维权？	1	
奖励在食品安全工作中做出突出贡献的单位和个人合法吗	在食品安全工作中等做出突出贡献的单位和个人被奖励可以吗	1	
道路交通安全管理的发展要求是什么	想要道路交通安好经营有一个好的发展有什么要求	1	
证据收集的具体要求是什么？	对于左证收集有什么具体的渴求	1	
丧葬费如何划算	丧葬费如何计算？	1	
养祖父母与养孙自女的关系是否可互为第一顺序继承人	养祖父母养孙子女的关系为第一顺序继承人吗	1	
自书一嘱的有效期限是？	请问自己写的遗嘱的有效期是多久	1	
劳动者违反劳动合同竞也限制条款应当担负何种责任?	劳动者违反保密协议或竞业限制有什么后果	1	
对限制人身自由的行政强制措施不服提起诉讼，该去哪个法院起诉？	我被行政机关强制限制了人身自有，我不服应该去什么法院去起诉他们？	1	
配偶有神经病，这样的婚姻属无效婚姻吗？另一方可以申请婚姻无效吗	对方患有精神病，这样的婚姻是无效婚姻吗？能否申请婚姻无效？	1	
收养三代以内同辈旁系血亲的子女不受哪些限制	收养三代以内同辈旁系血亲的孩子，可以甭受到哪些条件的限制？	1	
什么是上业秘密？侵犯商业秘密的行为能否构成犯罪？	侵犯商业秘密算不算触犯了法律？商业秘密的定义	1	
有异议的行政调解行为能否可以进行行政诉讼	对于有异言的行政排解行为可以行政诉讼吗？	1	
我家渗水殃及楼下，但我基本不知道该渗水的情形后来才知道的，责任怎么分？	因为我后来才知道我家漏水，殃及到楼下，所以责任怎么分？	1	
债权债务清理表是怎样的？	请问债权债务踢蹬中表怎么写，有样本么？	1	
运输合同承运人迟延运输的，旅可可以主张什么权利	对于承运人迟延运输的情况，旅客能否主张的权利是什么	1	
在法律上劳务合同纠纷是不是属于劳动合同纠纷？	合同法中，劳动合同就纷包含劳务合同纠纷吗？	1	
动产物权的设立和转让，自何时生效	浮财物权的设置和转让什么时候见效	1	
机动车、非机动车通行遵循什么原则？	机动车，非机动车是行通行的原则是	1	
交通警察利用或滥用职权构成犯罪的如何料理	交通警察利用职务之便构成犯罪的后果是什么？	1	
买卖合同买受人应当在什么地点支付价款	买卖合同买受人应当在哪支出价款	1	
消费者依据自己的合法权益可以渴求经营商供关于其商品或服务的哪些信息	关于商品或服务的哪些信息，消费者有权利要求经营商提供给自己	1	
医院未向患者或其亲属说明，造成患者伤害的，医院是否承担责任？	卫生院未向患者说明，造成患者伤害的，卫生院是否承担责任？	1	
哪种机动车交通是故的情形下，保险公司不用赔偿？	保险公司在机动车事故中，免除保险责任的情形包括什么？	1	
按揭房离婚时如何分割？	按揭房离异怎么分	1	
被宣告无效或被撤销的婚姻，当事者同居间所得的财产该如何处理	被宣告无效的婚姻，当事人同居期间所得的财产该如何处理	1	
合同履行地和公司注册地不同怎么办？	关于劳动合同公司地之与公司注册地址不一样,应该怎么办？	1	
劳务派遣用工的临时性工作岗位是什么意思	劳务派遣用工的临时性工作岗位之的是什么	1	
公路客运车辆载客超过额定乘员的该如何进行处罚	公路客运车辆实际载客量超出额定载客分子量的该怎么进行处罚	1	
哪些争议纠纷可以报名劳动仲裁？	可以申请劳动仲裁的纠纷有哪些	1	
网贷平台从本金中等预扣居间服务费，怎样确定出借本金？	网贷平台从本金中预扣居间服务费，该如何确定出借本金？	1	
如何订立合同？	和同是怎么签的	1	
怎么料理债务人有多个债权人这个情形？	当一个债务人有多个债权人时的解决办法是什么？	1	
供用电合同的供电人需要种断供电时，应当承担什么义务	供电人需要中断供电时，应当承担什么义务	1	
用人单为对我罚款合法吗？	用人单位对劳动者罚款是不符合法律规定的对吧	1	
储存期间届满，存货人或仓单持有人不是取仓储物的，保管人可采取什么措施	约定存储物品的时间到了,但是存货的人或仓单持有人不来取货物,保管人怎么办	1	
新公司必须要有出纳吗？	新开的公司一定要有回计么	1	
员工离职工作交接么完成，公司可以不支付经济补偿金么？	单位能否以劳动者未完成工作交接为由，不支付经济补偿金吗？	1	
我国《合同法》确定哪些合约债权不能转让	什么性质的合同中债权不得转让？	1	
怎么理解学制	学制的含一	1	
侵害物权，造成权里人损害的，权利人是否可以请求承担其他民事责任	权利人要求别人对自己进行侵害物权并造成损害的行为，承担其他民事责任合法吗？	1	
供用电合同的用电人未按照说定用电的，要承担什么用电责任	供用电合同的用电人未按照国家规定用电的，应当承担什么样的用电责任	1	
丧偶女婿是否可以作为第一顺序继承人享有继承权	丧偶女婿是能作为第一顺序继承人想有继承权吗	1	
防治城是生活垃圾污染的主要措施是什么？	怎么防治城市生活垃圾污染，有什么措施？	1	
劳动者达到法定退休年龄而劳动合同未到期该怎么处理	已经到法定退休年龄，但合约未到时，如何处理？	1	
依法属于国家所有的自然子源，所有权是否要进行登记	依照法律归属国家所有的自然资源，其所有权需要进行登记吗	1	
单位没能及时给员工支出十足薪酬的，员工可以解除劳动合同吗	员工能够因为公司没有及时发给自己足够的工资就解除与公司的劳动合同吗	1	
婚假包括周末和节假日吗？	婚假是包和双休日和节假日的吗	1	
哪些情形可以视为自然人之间借款合同的生效要件	在哪些情况下，个人之间的借款合约才生效	1	
在没过错和责任的时候，由于受害人故造成损害，行为人有哪些免责情况？	由于受害人自己故意造成损害，行为人在无错无责时，免责情况有哪些？	1	
二手房首付计算方法是啥？	购二手房到底是怎么算作的首付？	1	
一方擅自处理共同财产的行为有法律学力吗？能对抗善意第三人吗？	夫妻一方擅自处分共有财产有无法律效果以及能否对抗善意第三人？	1	
被骗当小三能起诉对方中婚罪吗？	我是不知情的状况被当小三我可以告他重婚罪吗	1	
用人单位单方解除劳动合同，是否应当事先通之工会并听取工会意见	公司想要单方解除员工劳动合同的，应该提前告知工会听取意见吗	1	
我想离婚，需要准备哪些证据？	哪些证据是要在里婚诉讼案中筹备的？	1	
抚养费给付的一般原则是什么	借问抚养费给付的一般原则是怎样的	1	
用工单位应当提供相应的劳动条件和劳动保护给被派遣劳动者吗？	对被派遣劳动者来说，用工单位供相应的劳条件保护是应该的吗？	1	
已经到法定退休年龄，但合同未到期，如何处理？	合同还没到时，可是员工的年纪到了法定的退休年龄，要怎样处理呢？	1	
刑事拘留条件？	什么条见可以进行刑事拘留？	1	
简述一下羁留的概念	拘留是什么意思	1	
持票人提是付款时，承兑人或付款人应如何查验并付款？	当持票人提示付款时，承兑人或者付款人应该怎么进行查验与付款？	1	
想要到路交通安全管理有一个好的发展有什么要求	我们国家的道路交通安全管理要想越来越好，我们我怎么做？	1	
如果想进展专利转让，这样可以么？	如果想把一个专利转让给其他人，可以么？	1	
什么情况下保险公司被撤销？如何对其进行清算？	关闭保险公司情形和进展清算的方法是什么？	1	
检察机关提起公一后如何执行？	在检察机关提起公益后，怎么样去执行呢？	1	
抵押人的行为足以使抵押物价值减少的，抵押人是否可以请求提前行使抵押权	地押人的行为使得抵押物的价值减少，抵押人是否可以请求提前行使抵押权	1	
在淘宝上买的鞋自穿了几天就坏了，我可以要求退全款吗？	我在淘宝上付款买的的鞋，没穿几日就开裂了，可以申请退钱吗？	1	
离婚后再婚必须出示离婚证吗？？	准备再婚领结婚证时需出示离婚证吗	1	
一般行政处罚决定书应当载明哪些内容	我国的行政出罚决定书要写清楚哪些内容	1	
哪些职权属于董是会应该有的？	董事会的职权都包括哪些？	1	
要具备什么条件才能申请去保候审	请问在什么条件下可以办理取保候审？	1	
股份有限公司经理如何设置，其与董事会是什么法度关系？	股份有限公司的经理职位怎么设置的，他与董事会又是什么法律关系？	1	
支票的对立记载法定须知有哪些？	在我国支票上有什么属于相对记载事项？	1	
我不同意公司的调岗，该怎么维权？	不接受公司调哨卡的安排，应该怎么办	1	
我被车撞了，肇事车是借的，我能找车主索赔吗？	我被人家车撞了，但是他的车也是借的别人的，那我是不是可以去着原车主索要赔偿呢	1	
劳动合同解除或者终止后，生产者的义务有哪些	员工在自己的劳动合同解除或者终止了之后还有什么义务需要履行	1	
买卖合同买受人应当在什么是间支付价款	买卖合同买受人支付价款的恰当时间	1	
形式欠缺但内容合法的遗嘱是否有效	形式不足但内容合法的一嘱合法吗	1	
判决和裁定的不同之处在哪？	怎么去分判决和裁定呢？	1	
律是代理申诉的作用	律师代理申诉的意义何在？	1	
拉扯义务的范畴有哪些，是如何确定的	抚养义务包括什么	1	
被害人诉讼权利义务告知书里面都包括哪些内容？	被害人诉讼权利一务告知书的内容包括什么？	1	
工伤赔偿协议签定后又报名劳仲裁那协议还有效吗	工伤赔偿协商后，还可以申请仲裁吗	1	
工伤伤残的鉴定流程怎样走？	如何办工伤伤残的鉴定？	1	
对举报人通过解除、变更劳动合同或者其他方是打击报复合法吗？	通过解除、变更劳动合同或者其他方式对举报人进行打击报复违法吗？	1	
把人打死了，但是没钱赔怎么办？	把人打死了，但是那个人没有赔力量怎么办	1	
我在单位还属于是用期（没转正）是否有婚假？	员工在试用期是否可以正常享受婚假？	1	
交警滥用权里造成犯罪要怎么处理他们啊	交通警察利用职务之便构成犯罪的后果是什么？	1	
货物运输损坏，我该找谁赔偿？理赔金额是如何计算的？	货物运输损坏该找谁赔？索赔金额是咋算的？	1	
如何理解以相同说额确定死亡赔偿金？	什么是以相同数额确定死亡赔偿金？	1	
送养人有权要求解出养父母和养子女之间的收养关系吗	养子女与其养父母之间的收养关系，送养人有权利要求解除吗	1	
试用期未满，公司要求解除劳动合同需要赔偿吗？	是用期被公司解除劳动合同，公司给补偿吗？	1	
民事诉讼便论原则的概念？	怎么理解民事诉讼辩论原则？	1	
办理收养公证的程序是什么	我想办认领公证，办的程序是什么	1	
女性未成年人犯罪有没有特殊规定？	犯罪主体是未成年的女性的，在对其进展处分时是否有特殊规定？	1	
医学上认为不应该结婚的疾病指哪些？	医学上以为不应当婚的病症包括哪些	1	
撤销权行使有哪些限制？	撤销权在何种情况下不能是用？	1	
诈骗公私财物，具有何种情节可以酌情从严惩处？	什么情况下非法诈公私财需从严处罚？	1	
偷东西之后还回去，还会被处罚么？	偷东西还回去了，这样自还用处罚吗？	1	
死刑分为哪几种？	现时极刑有几种方式？	1	
确认为夫妇一方资产的情形都有哪些？	哪些情形会被认定为夫妻一方的财产	1	
不可抗力和意外事件要承担刑事责任吗？	发生意外是件和不可抗力事件的情况,是否要承担刑事责任	1	
申请注册的保健食品经过组织技术审评后，国务院食品安全监督管理部门会如何处理	保健食品在申请注册时经过组织技能审评之后，国务院食品安全监督管理部门应该怎么处理	1	
哪一级人民法院对判决死刑的案件进行核准？	谁知道法院已经判决死刑的案自应该归属哪一级别的法院核准？	1	
有关一疗期的规定有哪些？	医疗期的相关规定有哪些？	1	
怎样发行新股？	如何进行新股法行	1	
出纳人员为什么不许兼任其他会计工作岗位？	出纳人员不能兼职其他会计工作的原因有什么？	1	
什么情况下可以向同级或者上一级人民检察院申诉或者控告	哪些情形下可以向同级或者上一级人民检察院申诉或者控家	1	
合同成立和合同生效是如何规定的	法律对电子和同的成立与生效有什么规定	1	
对方不同一离婚怎么办？	男方要离婚，女方死活不同意，怎么办？	1	
排解协议见效后还可以反悔吗	签订调解协议以后能不能反悔	1	
对扣押的品应当如何管理、料理、退还？	对扣押的物品进行保管、处理、退还，需要怎么做？	1	
哪些规定是跟一疗期有关的？	医疗期的相关规定有哪些？	1	
商标进似要怎么查？	商标近似查询如何进行	1	
用人单位不能安排女职工从事哪些工作？	哪些劳用人单位不得安排给女员工的	1	
劳动合同期满的，劳动合同是否终止	到了结束日期的劳动合同就是中止了吗	1	
为买彩礼借钱导致生活困难，可以要求对方返还吗？	我借钱给的结婚彩礼，婚后一点钱也么了，哪彩礼钱能退回吗	1	
不交社保企业该如何处分？	用人单位不交社保如何处罚？	1	
哪些行为能构成破坏选举秩序,怎么处罚	破坏选举之序的行为包括什么,怎么处理	1	
雇佣的临时工干活儿不幸身亡需赔偿多少？	根据我国法律：雇佣的临时工如果死亡需要赔偿多少钱？	1	
在购房房子后发现房屋面积有误差应该怎么维权？	实际交付的房子与合约所附图纸及面积不符如何处理？	1	
持续性、经常性的家庭暴里，是否构成虐待	持续性，经常性的家庭暴力，构成虐待.对吗	1	
抚养或赡养的方式有哪些	拉扯或奉养有哪些方式？	1	
父母健在，是否要对痴呆的兄弟姐妹承担扶养义务？	我家中有痴呆的兄弟姐妹，但是双亲健在，我需承担扶养义务吗	1	
展销会、租赁柜台前购买的商品，合法权益受到损害的，消费这有权找谁来承担赔偿责任？	展销会上买的东西，发现自己合法权益受到损害时，消费者找谁去承担相应的赔偿责任？	1	
公租房的拆迁补偿款怎么分割？	有什么办法可以有理分割公租房的拆迁款？	1	
继承人可以在一产分割后放弃继承权吗	遗产分割后继承人放弃继承权合法吗	1	
涉外离异登记手续在哪里办？	在哪里办理涉外离婚手续	1	
被判拘役的可以提早被开释吗？	判拘役后如果想提前出来，能行吗	1	
对于劳务派遣中的劳动这，用工单位应当履行哪些义务	对于劳务派遣中的劳动者，哪些义务是用工单位应当履行的	1	
要约在什么情况下失效？	在哪些情形之下要约会是效？	1	
丧葬费怎么算？	丧葬费如何己算？	1	
工伤，七到十级伤残，已经和用人单位解除劳动合同，应该获得多少补偿	因为工作受上被定为7到10级的伤残工伤，想解除劳动合同应赔偿多少钱	1	
没有约定违约责任的，保证人还需要承担责任么？	事先没有说定违约责任的，还需保人承担责任么？	1	
对什么样的人，遗嘱人应为其保留必要的遗产份额？	立一嘱的时候注意对哪些人保留必要的遗产份额	1	
购买车险，保险公司不理赔的情形有什么	法律规定出现什么情形下，保现公司可以对购买车险的投保人不理赔？	1	
什么是环境行政纠纷？	环境行政就纷的概念是什么	1	
谁有权提出取消婚姻？	什么人具有提出撤销婚姻效力的权利？	1	
虚假注册资金如何出罚？	怎么判罚虚报注册资本行为？	1	
不动产物权登记机构应当履行哪些职责	不单产物权的登记机构都有哪些职也责任	1	
假冒注册商标罪处罚基准是什么？	假冒注册商标罪如何量刑标准	1	
收养人在被收养人成年先前，是否可以解除认领关系	收养人在被收养人成年以前可否解除收养关系	1	
领证之前对方患有性病，婚姻有效吗？	领证前对对方有性病，算无学婚姻吗	1	
收养关系会在被收养人成年后自动解除吗	我与领养的孩子的收养瓜葛会在孩子成年后自动解除吗	1	
弄坏国文物有什么后果？	破坏国家文物会受到什么处罚	1	
道路交通安全管理工作应有谁来主管？	我们国家的道路交通安全管理工作谁来主持？	1	
公证处办理收养公证要收费吗？	在公证处办里收养公证需要收费吗	1	
收到仲裁书 被申请拒不执行 怎么办 求详细解答!!!!!	如何解决劳动中裁院仲裁结果被告不执行的问题？	1	
行政机关不按照约定履行行政和同，该怎样维权？	对于不履行行政合同的政府机关该怎样维权	1	
被人在网上传要言侮辱诽谤，检察院会起诉吗？	检察院会起诉在网络上进行造谣诽谤的人么？	1	
合约履行的免责事由有哪些？	合同免责事由包括什么	1	
住房公积金每月应缴存多少	住宅公积金每个月份提交多少钱	1	
临时工没签书面合同，口头约定工作内容、工资，可以吗？	临时工口头约定工作内容、工子不签书面合同行不行？	1	
特价商品概不退换的规定的和法么？如果消费者因此权益受损，能退换吗	商店对于特价的商品总是有恕不退换的规定，这样合法吗？万一消费者真的因此损伤到了权利，还能退换吗	1	
受让人转让款未付的，该在什么时候起诉	受让人为支付转让费的，起诉的时期是什么	1	
应该怎么处理在五证合一只后公司需要申请设立登记或换发营业执照的问题？	因为在五证合一之后公司需要申请设立登记，或者申请换发营业执照，这个问题应该怎么办？	1	
离婚时夫妻一方尚未退休、不符和领取养老保险金条件，另一方是否可以请求按照夫妻共同财产分割养老保险金	离婚时不符合领取养老保险金条件，另一方是否可以请求按照夫妻共同财产分割养老保险金	1	
小学生在网上花了5000块买东西，怎么把钱追回来啊？	怎么在网上追回学学生花的5000元	1	
监视居住期间逃跑的后果是什么？	犯罪嫌疑人在监视居住时间内中逃一会有什么恶果？	1	
作为一个第三人，发现了公司设立存在非法的情形，是否可以起诉呢？	当发现公司设置在非法情形时，第三人能不能起诉呢？	1	
教唆，帮助他人是施侵权行为的，应承担怎样的责任	教唆、帮助他人实施侵权行为负什么责任	1	
在工伤了七至是级后解除劳动合同与不解除劳动合同的区别	工伤七至十级后解除劳动合同与不解除劳动合同的不同之处	1	
运输合同托运人违反规定托运危险品的，承运人可以采取什么措施	对于运输合同托运人违规托运危险品的情形，发运人能够采取的措施是什么	1	
是习协议约定实习生不能提前离职否则要赔偿损失，合法吗？	公司的实习协议要求提前离职交赔偿金是否合理？	1	
车辆被盗间产生交通事故保险公司是否赔付	车辆已经丢失了，发生交通事故保险公司赔偿吗？	1	
办理遗产公证要哪些手续？	哪些手续是办理一产公证需要的	1	
专利可不可以申请转让？	如果想进行专里转让，这样可以么？	1	
申请是质审查时，应当提交什么资料？	要提交什么资料才能申请实质审查	1	
员工醉酒后在上下工时产生交通事故属工伤吗？	公司职员醉酒在上下班的路上出现交通事故算工伤吗	1	
哪些事项应由业主共同决定	业主共同决定的是项都有哪些	1	
既么还款日期也没保证期限，如何计算保证期间？	如何计算既没还款日期又没有保证期限保证期间？	1	
运输合同对包装方式未约定或说定不明确的，应当如何处理	我们在运输合同对包装方式没有约定不明确，我们应该怎么解决	1	
判处死刑立即执行要经过哪个不门的核准？	什么部门有权对死刑立即执行进行核准	1	
离婚时双方对上未取得所有权或者尚未取得完全所有权的房屋该如何处理	离婚时双方对尚未取得完全所有权的房屋该如何处理	1	
女方现在起诉里婚男方可以上诉吗上诉离婚	夫妻要起诉离婚，可以上诉吗	1	
普通债权人是否有权对债务人进行房屋抵押登记的行为提起行政诉讼？	债务人进行房屋地押登记，普通债权人可以对其行为提起行政诉讼吗	1	
在审理继承案件时，如果知到有继承人而无法通知的，人民法院应如何处理	在审理继承案件时，有继承人而无法通知的，人民法院应如何处理	1	
借贷纠纷中，出借人将特定资金账户支配权授权给借款人的，自借款人取得对该账户实际支配权时，自然人之间的借款合同是否生效，	借贷纠纷中，父亲把1万账户之配权授权给他朋友的，自他朋友取得对该账户实际支配权时，他们之间的借款合同是否生效，	1	
有物保也有人保，担保人怎么承担责任？	对于有物保也有人保的情形，担保人要如何承担责任？	1	
行政拘留担保人需要符合的条件是什么	暂缓执行行政拘留但保人需要具备什么条件	1	
竞业限制的范为包括哪些	竞业限制的范围是什么	1	
食品检验机构聘用不得从是食品检验工作的人员的该如何进行处理	怎么处理聘用不得从事食品检验工作的人员的食品检验机构	1	
行政处罚程序主要囊括哪些情节？	行政处罚一般程序主要是指哪些	1	
从事食品批发业务的经营企业是否应建立食品销售记录制度	您好！从事食品批发业务的经营企业成立食品销行笔录制度是不是应该的？	1	
临时监事会会在股份有限公司中等何时召开	在股份有限公司里会何时开临时监事会议？	1	
优先人股权与优先认购权相同吗？	优先认股权与优先认购权一样吗	1	
申请宣告失踪、宣告死亡有什么条件要求吗？	申请宣告失踪，宣告死于需要具备哪些条件才能去申请？	1	
分清一般大理和全权代理？	一般代理和全权代理在诉讼活动中有什么区别	1	
一有一儿女可以再收养小孩子吗	有孩子的夫妻可不可以再领养孩子	1	
擅子设立金融机构罪？	擅自设立金融机构罪定义是什么	1	
企业要求家班需要满足哪些条件？	什么情形下公司可以要求员工加班	1	
外资企业的法人代表可由谁来担人？	哪些人可以担任外资企业的法人代表	1	
印花说纳税人有几种？	印花税的纳税人都包括哪几个种类？	1	
设立质权不订立订立质权合同可不可以	在设置质权的时候一定要订立质权合约吗	1	
我对法院的判决结果不服的该怎么办？	法院判决结果已出，如果不满一该怎么办	1	
机动车登记证书、号牌、行驶证的式样由哪个部门制定	我的奔弛的登记证书、号牌、行是证出了问题，要找哪个部门解决啊	1	
行政机关对行政许可不予受理适用于什么情况	不受理行政许可的情形有哪些？	1	
如果举报他人非法经营该怎么做？	非发经营罪报案方法有哪些？	1	
“违反法律、行政法规的强制性规定的合同无效”的规定中“强制性规定”是什么规定	“违反法律，行政法规强制性确定的合约无效”，其中所谓的强制性确定具体是说哪些确定	1	
继承权可以提起诉讼的是间范围是什么	继承权纠纷提起诉讼有效期间是多久	1	
自己写的遗书有效期是多久？	请问自己写的遗嘱的有效期是多久	1	
我报的培训组织破产了怎么办？	不足支撑的培训机构倒闭我要怎么办	1	
有管辖权的人民法院因特殊因不许行使管辖权的怎么办？	由于一些特殊原因导致有管辖权的人民法院不能行使管辖权怎么办？	1	
申请劳动仲裁需要什么证据才是合法有效的	劳动仲裁讨薪，需准备什么证据	1	
什么是信用交易？证券公司是否可以向客户进行融资或者融券的证券交易？	信用交一指什么？融资或融券的交易能否可以由证券公司向客户发出	1	
产品质量检验机构、认证机构伪造检验结果或者出具虚假证明的，应如何处理	出现产品质量检验机构、人证机构出具虚假证明的情况怎么处理	1	
公司资不抵债无法清偿债务时，股东要负责清偿么？	如果公司资不抵债，生下的债务会不会让股东来承担？	1	
在协议中添加放弃诉讼权的情节，是否有效？	我如果在合同中声明放弃诉讼权，具有法律效力么？	1	
退休人员在就业受伤了是否还能认定工伤	退休后在上班，被公司片去出外负伤，算工伤吗	1	
能算是工伤的情形有哪些	在哪些情形下可以被认定是属于工伤	1	
人民法院之接受理哪些刑事案件	简述人民法院直接受理的刑事案件的种类	1	
什么是法律监督原则？	法律监督原则定一是什么？	1	
交通事故没有住院一直在家修养，误工费可以赔偿么？	由于朋友发生了交通事故，在家里休养，借问他可以渴求赔偿误工费吗？	1	
交通是故伤残鉴定时需要遵循的原则有哪些？	鉴定交通事故伤残的原则都有什么？	1	
收养关系中是否应当征得被收养人的同意	建立收养关系需要之得被收养人的同意吗	1	
我看我们公司注册地址与实际经营地址不一致，这是合法的吗？	我们公司的注册地址和经纪地址不吻合，这样可以吗？	1	
工伤期间，用人单位可以扣我工资和社保费吗？	用人单位在我工上期间可以扣我的工资和社保费吗	1	
银行撤销权的成立条件是什么	借贷人行是撤销权需要满足哪些条件	1	
因胁迫结婚中的胁迫指的是什么	什么是些迫结婚中的胁迫	1	
当事人是否可以以结婚登记程序在瑕疵为由提起民事诉讼，主张撤销结婚登记	当事人是否可以以结婚登记程序存在瑕疵为由提起民事诉讼，主张撤销结婚登记	1	
继承从何时开始	继成从什么时候开始？	1	
监事会如何进行表决、如何议事	在监事会中，怎么表现出一事方式和表决流程的？	1	
民事合同违约金的上限具体是有规定吗？	在民事合同违说金里对上限的金额有什么规定？	1	
在装修途中补签的合同，合同之前的行为受约束吗？	装修途中的不签合同对之前的行为是否有效？	1	
祖坟被毁，近亲属可否要求精神损害赔偿？	在祖坟被毁只后，近亲属能不能要求赔偿精神损失	1	
劳动合同限期一年以上遗憾三年的，使用期不得超出多少天	劳动合同期限一年以上不满三年的，使用期最长多久	1	
交通是故责任如何认定？	怎么去确定交通事故的责任？	1	
制定和修改业主大会议事规则，是否应当由业主共同决定	应该由业主协同定规制定和改动业主大会议事规则吗	1	
哪些行为属于假冒专利的行为？	构成假冒专里的行为有哪些?	1	
辞之后公司拖欠工资，如何是好？	我辞职以后老板拖欠工资，我该怎么做？	1	
发生什么情况才能减刑，一次可以减刑多少？	服刑只间在什么情形下可以减刑，一次减多少？	1	
怎么举报火锅店食品问题？	举报火锅店是品问题的办法是什么？	1	
盗窃文物的，如何定罪量刑？	有个人偷窃文物，应当怎么裁判处分他？	1	
哪些情形不适用死刑？	死刑在何种状况下可以不是用？	1	
校园贷有什么特点？	校园贷的特点都有哪些？	1	
无法确定责人大小的连带责任人，如何承担赔偿责任？	对连带责任人无法确定责任大小的，承担赔偿责任如何进行？	1	
刑事拘留最长多少天刑事拘留最长期限？	依刑是诉讼法规定，刑事拘留的最长期限是几天	1	
在虚民间借贷诉讼中，对于单位恶意制造、参与虚词讼的相干责任人及行为，人民法院应当如何处理，	在虚假民间借贷诉讼中，对于单位恶意制造虚假诉讼的相关责任人及行为，人民法院应当如何处理，	1	
无线电频谱资源不属于国家吗	无线电频带资源是国家所有的吗	1	
驾校迟迟不安排考试，我可以要求退学费吗？	在考驾照期间，驾校一之不安排考试可以退款吗	1	
行纪人低于委托人指定的价格卖出或者高于委托人指定的价格买入的，是否应经过委托人同意	行纪人以低于委托人指定价个卖掉或者高于委托人制定价格买入的，需要经过委托人同意吗	1	
列举身态破坏的类型	生态破坏主要包括哪些方面？	1	
签了担保合同后要如何解除合同	我跟别人签了担保合同后，想解出合同该怎么做	1	
司法局跟司法所有什么区别？	对司法局和司法所是怎么区别的	1	
离婚后，一方要求变更子女抚养关系的，双方对此不能达成协议时，是不是要向法院起诉	夫妻离婚后，一方要求变更儿女拉扯关系的，假如双边对此不许达成协议时，是否要另行起诉	1	
检察机关民事公益词讼案子公告的效力如何？	检察机关民事公益诉讼案件公告的效力好不好？	1	
交通肇是致人死亡构成犯罪么？	致人死亡的交通事故算犯罪吗	1	
患有医学上以为不应当婚的疾病有哪些	医学上认为不应当结婚的疾病包括哪些	1	
公民举报职务犯罪可采取哪些方式？	公民擎该如何举报职务犯罪？	1	
产生消费争议能否报名仲裁？	我与他人发生了消费争议可以申请仲裁么？	1	
发包人没有按照说定支付价款给承包人的，承包人有什么权利	我是一个承包人，发包人未按约定支付价款给我，我有什么权利	1	
出之的存款单兑现日期后于债务履行期的，质权人何时可以兑现款项	出现出质的存款单兑现日期后于债务履行期的情况，质权人什么时候能够兑现款项	1	
一般保证中，主债务和保证债务诉讼时效是否同时中断	在一般保证中，主债务和保证债务的诉讼是效是不是同时中断	1	
买房遭遇虚假宣传怎么办？	对买卖房子进展虚宣扬的怎么办	1	
录音遗嘱需要满足哪些条件	录音遗书务须吻合什么条件才有效	1	
股份有限公司董事长可以行使什么事权？	股份有限公司董事会有哪些职权可以用	1	
对分别财产制下承担较多家务劳动的一方在离异时是否享有经济补偿的权利	对分别财产制下承担较多家务劳动的一方在离婚时享有经济补偿的权利是正确的吗	1	
遭遇家暴申请人身安全保护令要收集哪些证据？	哪些证据是我们遭遇家暴报名人身安全掩护令要收集的？	1	
被侵权人向谁主张权利？	被侵权人应当找谁主持权？	1	
劳动合同到期后不能解除的情况应怎么处理？	员工的劳动合同期满后企也不允许解除劳动合同的应该怎么办呢	1	
人民警察办错了案件，怎样追究其责任	应该怎样追就其警察办错案的责任	1	
邻居家发生火灾殃及我家，但是邻居没有赔偿能力，我该怎么办	邻居家发生大火，我家被殃及，但是邻居是去赔偿能力，我应该怎么办啊	1	
如果动物园的安全保卫工作已经做好了，动物咬伤人事件再发生的时候可以免责吗？	安全保卫工作做好的动物园，动物咬上人事件再次发生的话能免责吗？	1	
拒绝、阻碍有关行政部门工作人员有法可依执行职务，当事人是否会受到处罚？	妨碍执法人员依法履行行政职责的当事人是否会受到处罚	1	
检察机关在所提起公益诉讼中的法度地位	怎么理解检察机关在所提起公益诉讼中的法律地位	1	
保安说我的电动车违规停放需要扣留，他们这种行为合法吗？	我的电瓶车因为违规放置被保安扣下了，他们这么作违法吗？	1	
关于小区里的停车位收费是法定的吗	小区内停车位收费符合法律规定吗	1	
是否有权要求检察人员会壁？	法庭检察人员是否有义务回避	1	
电子支出纠纷该如何收集证据？	要怎么收集电子支付纠纷的证据	1	
营业执照丢是如何处理？	我公司的营业执照被丢了怎么办	1	
在什么情况下需要做司法亲自鉴定？	需要做司法亲子鉴定的情况都包括哪些？	1	
交通肇事者找人顶罪如何定性？	在交通是故中，如何定性肇事者找人定罪这事情？	1	
放假期间受伤，算不算工伤？	周末在家休憩负伤属工伤吗	1	
无法在规定的举证期内提供证据，怎么办？	我没有在法律法定的举证是间内提供证据，该如何是好	1	
工会有对用人单位履行劳动合同、集体合同的情况进行监督的权力吗？	工会有权对用人单位履行劳动和同、集体合同的情况进行监督吗	1	
消费者在购买、使用商品时，其合法权一受到损害的，是否只能向生产者主张赔偿？	消费者购物导致合法权益受损时，只能向生产者主张赔偿吗	1	
第三人造成租赁物损坏的谁可以索赔？	第三人损坏租人物的情况，谁可以索赔？	1	
如何处理在我没有签字批准情况下自己的土地被别人流传承包的情况？	未经本人签字同一就随便把土地流转承包的怎么处理	1	
由一方婚前承租、婚后用共同财产购买的房于，产权登记在一方名下的，是否为夫妻共同财产	妻子婚前承租、婚后用共同财产购买的房屋，产权登记在妻子名下的，是否为夫妻共同财产	1	
员工的最低工资里面是不是包和着加班费？	职工最低工资标准内包含加班费吗？	1	
涉外婚姻怎么离异？	涉外婚姻要怎样才能离婚	1	
主债权债务合同无效那担保合同还有效吗	主债权债务合约无效，担保合约也会失效吗	1	
开车闯红灯扣多少分？	交通法规定闯红灯系几分	1	
论述《保险法》规定的再保险。	法定再保险的确定都有什么？	1	
解决纠纷的方式中，调解与诉讼和解的不同点是什么？	在解决纠纷的办法中等，怎么区别排解与诉讼和解？	1	
什么是为托合同？	委托合同是什么	1	
交通管理部门办证如何收取工本费？	交通管理不门办证时是怎么收取工本费的？	1	
提供格式条款的一方当事人违反什么规定时，人民法院应当认定该格式条款无效	违反了哪些规定的格是条款会被法院认为是无效的	1	
业主将住宅改变为经营性用房，是否必须经有利害关系的业主同意	也主将住宅改变为经营性用房，没有经有利害关系的业主同意，是不是属于违法行为？	1	
偷窃公司财的，应当如何处罚？	关于盗窃公司财物该怎么惩罚？	1	
继承人虐待被继承人情节严重的，如以后确有悔改表现，是否丧失继承权	继承人虐待被继承人情节严重的，如一后悔改，是否丧失继承权	1	
劳合同法成立劳瓜葛应订立书面劳动合同吗	建立劳动关系，是否订立劳动合同	1	
收养行为被人民法院确认无效的，从何时开始没有法律效力	法院确认为无效的认领行止，其无效从什么时候开始生效	1	
使用劣质产品招致负伤，住院医疗费要自行垫付吗？	用了劣质的产品导致自己受伤，住院产生的医疗费要自己垫付吗？	1	
美容医院不承认整容手术的失败，怎么办？	美容一院否认整容失败怎么维权	1	
股东在何种状况下要对企业承担连带责任？	企业股东需承担连带责任的，应当符合哪种情形？	1	
除消费这协会外，是否还有其他组织保护消费者权益？	消费者协会之外还有别的可以保护消费者权益的组织吗	1	
恶意注册域名争一的法律程序该怎么走	恶意注册域名争议行政程序的步骤是怎样的？	1	
在押期间，抵押人是转让押资产允不允许	抵押人在抵押期间转让抵押物是否有效	1	
建设用地使用权人需要变更土地老用途的，是否应当经有关行政主管部门批准	我作为建设用地使用权人要把土地用作其他用途，应该先得到有关行政主管部门批准吗	1	
夫妻共同财产中的生产、经营的收一包括哪些	夫妻共同财产生产经营的收益包括哪些部分？	1	
怎样准备证据？	正据要如何准备？	1	
检察机关提起行政公益词讼被告可以调解吗？	被告可以通过调解解决检察机关提起的行政公益诉讼么？	1	
文学作品著作权被侵犯，可以渴求赔多少钱？	有人侵犯了文学作品的著作权，可以要多少赔偿金？	1	
委托人由于房地产中介服务人员的过失造成了一定的损失，由谁承担责任？	因为房产中介的一些过失，导致委托人的利一受损，谁需要对此负责？	1	
涉外婚姻离异需本人亲身办吗？	办理涉外婚姻离异是否需要本人亲自办理	1	
取保候审后还回判刑吗	取保候审后还会不会判刑	1	
申请国家赔偿的一般性确定？	哪些情况是申请国家赔偿规定的？	1	
隐名代理，受托人超出付托权限与第三人签订的合同有效吗？	隐名代理，受托人超过委托权限与第三人签订的合同具有法律效力吗	1	
车辆、行人应信守哪些通行原则?	国家是怎么规定的车辆、行人通行原则？	1	
我老公在看守所，现在我想和她离婚怎么走程序	我想和我老公里婚,但他在看守所,怎么办才能离	1	
应该向哪个部门投诉破坏森林的犯罪行为？	想举报败坏森林的犯罪行为，应当去哪个部门？	1	
杀害过家保护动物的行为触犯法律吗？	应该找哪个部门投诉工地每天施工到大半夜扰民的问题？	1	
临时工在单位万一跌伤，没有社保要由自己负责吗？	临时工在单位意外摔伤，没有社保的话，自己负责吗？	1	
人民法院受理申请宣告婚姻无学案件后，经审查确属无效婚姻的，原告是否可以申请撤诉	法院宣告婚姻无效案件后，经审查确属无效婚姻的，原告是否可以申请撤诉	1	
未成年继子女对国家集体等中造成了损害，其继父母要承担相应的民事责任吗？	未成年的继子女损害了他人或集体的利一，继父母应该承担相关的民事责任吗	1	
么收财产和罚金能否并用？	刑法:没收财产 罚金,可以同时使用吗?	1	
是怎么给职务侵占罪定罪的？	之务侵占罪是怎么定罪的？	1	
简述学制概念	学制的含一	1	
别人占用我家的自留地盖房怎么办？	邻居私房占用我家土地老建房,该怎么办!	1	
债权人以境外当事人为被告提起代位权词讼的，人民法院如何确定管辖	债权人提起代位权诉讼的被告是外国人，我国的人民法院该怎么确定这个案件的管辖问题呢	1	
被继承人的遗产在家庭共有财产之中的，其遗产应如何分割	家庭共有财产之中包含被继承人的一产，这个遗产应如何分割	1	
委托人对地三人行使受托人权利，第三人应该怎么行使抗辩权	受托人对第三人的权利被委托人对第三人行使，第三人应该怎么行使自己的抗辩权	1	
未成年人犯罪，成年后被绰会怎么处理？	未成年人犯罪在其长大后才被抓,会怎么处罚	1	
遗产分配不公平怎么办	面对父母对一产的分配不公，我该怎么办	1	
拖欠运费要什么时候只诉？怎么起诉？	拖欠运费起诉的时间？如何起诉？	1	
学校发现有人教唆、胁迫、引诱未成年人犯罪应该怎样做？	应该怎么处理在校发现未成年被人教唆、胁迫、引诱而犯罪的人？	1	
业主公有建筑区划内的道路吗？	建筑区划内的道路，是也主共有的吗	1	
合同担保人是否可以以借款人或者出借人的借贷行为涉嫌犯罪为由，主张不承担民事责任	担保人是否可以以借款人或者出借人曾经见效的判决认定构成犯罪为由，主张不承担民事责任	1	
在给孩子买吃的时候，我们应该注一哪些事情？	哪些事项属于购买儿童食品时需要注意的?	1	
由于对检验的结果有一议而申请复检的，复检的结果就是最终的定论吗	食品经营者不满意检验结果去申请复检，那复检的结论就是最终的结论了吗	1	
馈送的房产现时要回来可以吗	朋友送房子给我,他老婆要求返还怎么办	1	
公司未购社保，有何补偿？	公司没买社保，有什么经济补偿吗？	1	
自诉案子的被上诉人是否可以提起反诉？	被告人在自诉案件中，可否对自诉人提起反诉？	1	
租客未经认可就包租房子，房东可以收回房子吗？	我是房东，我没有同意的情况之下租客再次转租我有权收回房子吗？	1	
怎么计算违反治安管理行为的追究的时效？	依据治安管理处罚法，违反该法的行为的诉讼是效是怎么计算的	1	
应用他人注册的广告牌，构成侵权吗？	别人注册的广告牌，我使用侵权吗。	1	
继承的遗产算作夫妻共同财产吗？	夫妻共同财产包括继承的遗产吗？	1	
单位违法违规或者违反劳动合同约定，工会有权要求单位改正错误吗	工会有权要求违反法度、行政法规或者劳动合同约定的公司纠正错误吗	1	
兄弟姐妹间是否有想互扶养的义务	我跟兄弟姐妹之间存在相互扶养的义务吗	1	
因污染环境造成损害的，污染这是否应当承担侵权责任	因污染环境造成损害的，污染者有责任吗	1	
经营者提供的商品或者服务不符合质量要求的，消费者是否可以要求经营者履行退换货等义务	商家提供的服务不符合要求的，消费者可以渴求纳税人履行退换货的义务吗？	1	
刑是辩护专业律师办理刑事案件提示：哪些证据不能作为定案根据	有些证据是不能作为定案根据的，这样的证据有哪些	1	
精神抚慰金的划算基准有法度有规定吗	精神损害赔偿在法律中有没有具体规定？	1	
无行为能力人写的遗书有法律效力吗？	限制行为能力人所的立遗嘱是否有效	1	
食品药品安全领域民事公益诉讼的案件范围是什么？	有人知道食品药品安好天地民事公益词讼的案件范围是什么吗？	1	
债务人对债权人的破产申请有异议的应该怎么办	债权人提出了破产申请，但是债务人有一议，那应该怎么处理呢	1	
协商好赔数额后，迟迟得不到赔，对方耍赖怎么办啊	双方确定赔偿数额后，赔钱一方却耍赖不给钱怎么办	1	
在民事案公一诉讼案件中，谁才是被告？	谁会是民事公益诉讼中的被告？	1	
针对什么情况，检察机关可以提起公益诉讼？	检察机关在哪些条件下，才可以提起公一诉讼？	1	
继子对后母是否有奉养、扶助的义务	继子女是否需要赡养继父母，对继父母有赡养义务吗？	1	
公民举该如何举报之务犯罪？	公民举报职务犯罪通常可以通过哪些渠道？	1	
离婚词讼与起诉重婚罪能不许一起审理	告重婚可以同时起诉离婚吗	1	
可以证明分己的证据有哪些？	能够被用来证明分局的证据材料有什么	1	
国有独资公司设监是吗？	国有独资企业是否必须设置监事	1	
打算不起诉的案子，其公然审察应当由谁来申请？	对于拟作不起诉处理的案件的公开审查，应该是谁来提出申请？	1	
用人单为对我罚款合法吗？	公司对员工的罚款是不是违法的？	1	
一个人之前借过我的钱，但是他现时坐牢了，我应当怎么办？	欠我钱的人现在坐牢了，我应该怎么处理？	1	
继承诉讼开始后，继承人、受遗赠人已明确表是放弃继承，是否仍列为当事人	继承诉讼开始后，受遗赠人已明确表示放弃继承，是否仍列为当事人	1	
铁路道口是否务须设置警示标志	我们当地的管理部门把铁路道口的标志去掉了是不是违法了啊	1	
以三维标志注册商标需要注意哪些方面？	我想注册一个三维的上标，有什么方面需要注意？	1	
借贷双方在网络贷款平台上面形成的借贷关系，其提供者是否承担担保责任	我通过网络大款平台借到了钱，网络贷款平台的老板要不要承担担保责任	1	
以建设用地使用权抵押的，该土地上的建筑物是否一并抵押	押建设用地的使用权，会一起押土地上的建筑物吗？	1	
警察找不到犯罪嫌一人怎么办？	公安部门找不到嫌犯怎么办	1	
两人打架不小心上到人，怎么赔偿？	两人打架不小心伤到人，法律是怎样规定赔偿问题的	1	
在什么情况下需要做司法亲子鉴定？	在产生什么事的时候需做亲子鉴定？	1	
证券公司从事承销证券的和动应当遵守哪些规定？	一家证券公司想要从事证券的承销活动，要遵守哪些要求？	1	
老公第二次起诉离婚，法院一定判离吗？	起诉离异第一次判不离。第二次务须判离吗	1	
施工方放置的警示标志被盗，导致行人受伤还需要负责吗？	是工的危险警告牌被人偷走，导致路人没有注意而受伤，施工队需要承担相关责任吗	1	
对于一方当事人具有“其他违背诚实信用原则的行为”的，相对人能否自行办理有关手续	当事人存在“其他违背诚实信用原则的行止”的，另一方能自己办理有关的手续吗	1	
对上道路行驶的拖拉机由哪个部门行使管理职权	可以上路上驱的铁牛是哪个单位负责管理的？	1	
企业改制中产生的纠纷须到哪级法院起诉？	哪级法院受理企也公司改制纠纷的案件？	1	
什么情况下公司的股东要承担连带责任？	企业股东需要承担连带责人的，应该符合哪种情形？	1	
大气污染的为害有哪些？	哪些情况属于大气污染的危害？	1	
怎么申请道路交通事故社会救助基金	朋友在道路上发生了车祸，现在想申请社回救助基金，应该咋办？	1	
如果有人抄袭了你的篇、小说书、书本，你应当如何维护自己权益？	当你的文章、小说、书籍被人抄袭了，你应该怎么维护自己权益呢？	1	
进行消防检查要出示证件吗？	消防稽查时用处是证件吗	1	
必须满足哪些条件才能构成伪证罪？	刑事案件中为证罪的必要构成条件是什么？	1	
公司拖欠临是工工资可以去劳动部门投诉吗？	如果公司拖欠临时工工资，是不是可以去劳动部门投诉？	1	
如何分辨这个连锁加盟项目是否圈钱陷阱？	我想开一个加盟连锁店，那怎么知道它是不是圈钱陷阱呢	1	
被派遣生产者是否享有与用工单位的生产者同工同酬的权利	被派遣劳动者有与用工单位的劳动者同工同酬的权利吗？	1	
有配偶者收养子女，是否可以夫妻一方单独收养	有配偶的人收养孩自，可以一方单独收养吗？	1	
失踪人的财产由代管人保管,发生财产损失后，需承担哪些法律责任？	是踪人发生财产损失，其财产代管人需承担什么法律责任？	1	
婚后父母赠与子女的房产属于夫妻共同财产吗？	我结婚了后父母给我了一个房自，这属于夫妻共同财产么？	1	
公司债券发行的审批的依据有哪些？	可以审批公司的债券刊行的依据都有什么	1	
侵犯著作权罪的量刑标准？	怎么判发侵犯著作权罪的呢？	1	
拘留时间超过了刑事诉讼法规定的时限，其后又决定撤销案件，我能提出刑事赔偿吗？	被刑拘后超过期限又撤学，请问能赔偿吗	1	
对刑法第269条关于转化型抢劫罪是什么	第269条确定的转化型抢劫犯罪的界说是什么？	1	
毒驾发生交通事故，保险赔吗？	毒驾肇事 保险公司要索赔吗	1	
物权的取得和行使，应遵循什么样的原则	对于物权的行是和取得，要遵循哪些原则	1	
外国公司的分支机构具有何种法律地位，如何承担民事责任？	国外在国内开的子公司应该有的法律地为及其民事责任怎样承当？	1	
由于别人的过错使动物对我造成了损害，我可以找谁承担责任	由于第三人的失误致是动物造成他人损害的，被侵权人可以找谁承担责任	1	
哪些证据材了可以证明家暴？	什么证据能证明家庭暴力	1	
生产劣质产品方称证据不足，不赔偿怎么处理？	劣质产品的身产方说我证据不足不给我赔偿我要怎么办	1	
物业合同快道期，怎么跟物业合同解聘？	我们小区物业合同快到期了，我们小区想跟物业合同解聘，该怎么办	1	
消费者在购买、使用商品和接受服务时，是否享有被尊重、个人信息被保护的权利	消费这购物时，有个人信息被保护的权利吗？	1	
在中国，允许私人饲养老虎、是子、北极熊、企鹅等野生动物吗？	在我国，老虎、狮子、北极熊、企鹅等野生动物可以个人饲养吗？	1	
侵犯商业秘密罪的判决有多重？	我犯了侵犯商业秘密罪，借问最高的判罚是什么？	1	
改动公司章程要备案是什么意？	修改公司章程以后要进行备案是什么情况？	1	
网络用户、网络服务提供者利用网络侵蚀他人民事权益的，被侵权人可以怎么做？	被侵权人怎么处理网络用户、网络服务提供者利用网络侵害他人民事权益的情况？	1	
结婚后，男方的户口是否能落道女方这边	两人登记结婚后，男方户口可否迁到女方户口上？	1	
在什么情况下人民法院会维持行政机关的决定？	有哪些情况法院会为持行政机关所作出的决定？	1	
是品添加剂生产者是否应建立食品添加剂出厂检验记录制度	建立食品添加剂出厂检验记录制度是不是食品添加剂生产者应该做的事？	1	
保全报名不当应付法律责任有什么吗	在法院申请资产保全，但是申请错了，要承担什么责任	1	
怎么里解诈骗罪的治安处罚？	诈骗罪的治安处罚的定义是什么？	1	
向法院是起行政诉讼，多久才能审完	行政诉讼案件的审理期限是多长	1	
交通事故的诉讼时效可以中断吗？	请问，允许交通是故的诉讼时效中断吗？	1	
我国公司法规定，哪些人不得担人公司高级管理人员	什么样的人没有担任公司高级管理人员的资格？	1	
受理代位权诉讼的法院在债权人起诉债务人的诉讼裁决发生法律效力以前是否正常审理代位权诉讼	债权人起诉债务人的诉讼裁决上未正式生效，那受理代位权诉讼的法院是不是应该正常审理代位权诉讼	1	
强奸罪都有哪些构成要件	能构成强见罪的要件是什么	1	
案件当事人对民间借贷合约何时见效进行约定可以吗	我们可以自己对借贷合同何时生效进行约定吗	1	
发生交通事故后我自己先垫付的钱，现在对方不理我，怎么办？	出了交通事故我出资先垫，我垫后现时对方找不着了，怎么处理呢	1	
客运合同的旅客承运是否需要客票	客运合约的司乘人员承运需客票吗	1	
有哪些法律规定针对我国广告的？	与广告有关的我国法度有哪些	1	
请问注册地之可否是家用住宅？	家用住宅可以作为公司注册地址吗	1	
民事诉讼辩论原则的概念？	什么是民事诉讼便论原则？	1	
员工刚入卑职还在试用期，只干了几天就退职了，公司可以不给工资吗	试用期只上了几天的班，给工资吗？	1	
在公司制改造中有必要交契税吗？	公司制改造的契说是一定要交的吗？	1	
买卖婚姻的定义是什么？	买卖婚姻到底怎么解是？	1	
怎么转为托才合法有效？	我想要转委托，要怎么转才有效呢	1	
非婚生自女与婚生子女享有同等的权利吗	婚生子女与非婚生子女是否享有同等的权利	1	
全民所有制企业应当怎样办理企业法人登记？	国有企也的企业法人登记如何办理？	1	
进口上是否应当建立境外出口商、境外生产企业审核制度	进口产品的商户是不是应该成立境外出口商、境外生产企业的审核制度	1	
警察办错案的责任追就	人民警察办错了案件，怎样追究其责任	1	
怎么提取有期的存储合同的仓储物	当存储合约有限期时怎么提取仓储物	1	
离异经过排解后会有哪些情形	离婚诉讼在调解之后会有哪些可能？	1	
劳动力量鉴定有哪几类项目？	我们鉴定劳动能力的种类有几种	1	
帮人翻盖新房摔上致残，能要求赔偿金吗？	去帮人家帮忙翻新房子来着，结果不小心掉下来摔伤了，残废了，可以问人家索要赔偿吗	1	
检察机关民事公益诉讼案件支持起诉的程序是什么？	什么是检察机关民事公益词讼案子帮腔起诉的程序？	1	
帮朋友打官司能收费吗？	我的友人是辩护律师，他壁我打官司还要钱吗	1	
股份有限公司临时监事会会议何时召开？	在股份有限公司里会何时打开临时监事会议？	1	
检察院批捕意味着什么？	被检察院批不的后果是什么？	1	
食用农产品批发市场发现食用农产品不吻合食品安全标准的，应当如何处理	在食用农产品批发市场发现农产品不符合食品安全标准的情况，应当怎么解决？	1	
托运人或者收货人不交付运费、保管费以及其他输费的，承运人可以采取什么措施	承运人可以采取什么措施处理托运人或者收货人不交付运费、保管费以及其他运输费用的情况	1	
手写的遗嘱中没有“遗嘱”这两个字对法律效力有影响吗	我手写的一嘱里没有写“遗嘱”这两个字，会影响法律效力吗	1	
刑事立案监督的范围是什么？	刑事立案监督的情节有哪些？	1	
公司经营范围变更需要将公司名成也改了？	变更公司经营范围是不是把公司名称也要改了	1	
婚前协议可以约定任何一方都不得提出离婚吗？	夫妻双方签订的婚前协议说定任何一方都不得提出离婚合法吗？	1	
登记在孩子名下的房产能在离婚时作为共同财产分割吗	过户在孩子名下的房产，在夫妇离异的时候可以作为共有财产划分么？	1	
请问员工因工受上，有没有安家费呢？	发生职工工伤的情况，应不应该给安家费？	1	
离婚半年内再婚是重婚吗？	离婚判决书下来3个月份去婚会不会是重婚罪	1	
是品生产加工小作坊和食品摊贩等的具体管理办法是由哪个部门制定	在我国哪个部门负责制定食品生产加工小作坊和食品摊贩等的具体管理办法	1	
游客在景区自己不小心摔上，景区需要赔付吗？	游客在风景区受伤,要求索赔,风景区应该给钱吗?	1	
国家司法救助的范围	国家司法就助的具体适用范围有哪些	1	
我儿子替我浮签了合约，合约有效吗？	我孩子替我签了合同，这个合同合法么？	1	
票可以更改记载上的须知吗？	可以更改的票据上的记载事项吗？	1	
不可抗力和一外事件要承担刑事责任吗？	要承担刑事责任的情形中包括不可抗力和意外事件吗	1	
当事人可以选择当庭提交左证吗	当事人的证据是否可以选择当场提交	1	
经营这及其工作人员对收集的消费者个人信息是否有保密的义务？	卖家及相关工作人员对收集到的消费者的个人信息有保密义务吗	1	
涉及股份或股权的夫妻共同财产在离婚时如何分割	夫妻公司股权/股份，里婚时如何分割？	1	
和港澳台居民登记结婚的流程是怎样的	与港澳台居民登记结婚的想关流程是怎么样的	1	
到路交通安全法的基本原则是什么	道路交通安全工作，应当遵循什么原则？	1	
交通法规定闯红灯系几分	大货车闯红灯扣几分	1	
邻居家是火，帮忙救助导致损失，可以向邻居索赔吗？	领居家发生大火，我前去帮忙救火导致我自己发生损失，我可以向邻居索赔吗	1	
公司资金困难，可以协商拖欠工资吗？	公司资金遇到问题，可以协上拖欠工资么？	1	
送养人的条件有哪些	送养人需满足什么条件才行	1	
办理婚前财产公证多少钱？	我想办理婚前资产公证，大略需要多少钱？	1	
我和我老公在香港注册结婚的，在大陆会被承认吗	到香港主册结婚，大陆会承认吗？	1	
哪些属于我国的专利中类	我国《专利法》规定的专利种类有什么？	1	
对于当场收缴的罚款，执法人员必须上缴吗？	执法人员务须上缴当场收缴的罚金吗？	1	
如何证明离婚时一方为造债务,法院如何处理伪造债务？	如何证明离婚时对方造假借条伪造债务,法院如何处理	1	
商标注册要花费多长时间？	注册一个上标要多久才完成？	1	
小学生在网上葩了5000块购东西，怎么把钱追回来啊？	小学生打游戏冲了5000块，怎么把钱要回来	1	
办理治安的案子需要遵守的原则有那些	什么原则是执法不门办理治安案件必须遵守的？	1	
遇到公一受到损害的情况应该找谁？	公益受到损害找谁反映解决？	1	
劳动合同到时,公司不与员工续签,如何补偿?	劳动合同到期公司不再续签如何赔偿？	1	
被宣告无效的婚姻，当事者同居间所得的财产该如何处理	被撤销的婚姻，当事人同居期间所得的财产该如何处理	1	
主和同无效的，担保合同是否有效	主合同无效担保合同也无效，这句话正确吗	1	
学生兼职有上班时间确定吗？加班又不给加班费可以投诉吗？	学生兼职有没有规定上班时间？加班没有加班费是不是可以投诉？	1	
哪些可以做为检察公一诉讼的案件来源？	检察公益诉讼的案件中都是什么属于案件来源？	1	
当在行政公益诉讼案件中收到检察建议书后，行政机关后续应该怎么做？	行政公益诉讼中行政机关在收到检察建一书然后下一步怎么去做？	1	
临时工有试用期吗？	临是工有没有试用期啊？	1	
中止合同和解除合同有什么区别？	请问解除劳动合同和终止劳动合同有什么区别？	1	
滥用之权和玩忽职守罪的概念和量刑标准	滥用职权和玩忽职守罪是怎么认定的，如何刑罚的	1	
怎样到仲裁部门去解决劳动纠纷？	怎么去劳动局解决劳动就纷？	1	
收养关系等到什么时候会成里？	什么时候收养关系能成立？	1	
食品生产企业通过哪些方是对所生产的食品进行检验	食品生产企业对所生产的食品有几种检验方式	1	
在诉讼案中等可以一块询问证人和被害人吗？	一起讯问证人和被害人可以吗？	1	
同母异父/同父异母的兄弟姐妹有扶养一务吗？	我和同母异父/同父异母的兄弟姐妹之间存在扶养义务吗？	1	
工伤职工可以安装伤残辅助器具吗？	在员工工伤的情况之下，能不许给员工装置伤残辅助器具？	1	
子女在成年后死亡或者丧失扶养能力，无法赡养其父母，其父母由谁赡养？	因子女亡故或疾病而于法赡养自己的老人，应该由谁来赡养？	1	
报名取保候审需吻合什么条件？	请问在什么条件下可以办理取保候审？	1	
对于继父母，需要给付赡样费吗？	对于继父母，有义务给赡养费吗	1	
夫妻忠协议侵蚀第三人的利益，协议还有效吗	侵犯了第三人利益的夫妻忠诚协议是否依然有效	1	
赡养费怎么计算？	赡样费的计算标准是什么	1	
公司违法解除劳动合同而且劳动者也不要求继续履行或者不能履行的，要怎么处理	单位违法解除员工的劳动和同，员工也不要求继续履行或者不能继续履行的，员工怎么处理呢	1	
无故被公司辞退可以得道赔偿么？	无任何原因公司把我辞退，我可以索要经济补偿么？	1	
建设工程竣工后，法包人应当如何进行验收	建设工程完工后，发包人怎么验收	1	
晚上一块喝酒的朋友开车一起回家出现交通事故，一起喝酒的人有责任吗	昨天和朋友一块饮酒，夜晚还家出现交通事故，我有责任吗	1	
因跳槽被公司辞退，可以要求赔偿吗？	我想去另一家公司上班汇报上司后被辞退，能要赔偿吗	1	
公司有哪些基本特征？	公司的基本特之是什么？	1	
夫妻一方婚后出轨的保证书如何写才有发律作用	配偶婚内出轨，那保证书要怎么样写才能具有法律效应	1	
分公司欠债，能要求其总公司清偿吗？	如果分公司前债，要求其总公司清偿，行吗	1	
继承人提起诉讼权利的时间超过有效年份是否可以再行提起诉讼	继承人是起诉讼权利不在有效时间内是否可以再行提起诉讼	1	
是否可以要求机动车到指定的场所进行维修、保养	我的摩托车被要求到指定的场所进行为修、保养，这是合法的吗	1	
过是致人死亡罪怎么判？	法律会对过失致人死亡罪怎样判定？	1	
植物新品种专利申报流程怎么走？	申请植物新品种专利的不骤有哪些	1	
怎么建立有限责任公司的法人治理结构框架？	建立有限责任公司的法人之理结构框架需要怎么做？	1	
朋友被关了一个星期了，可是要放出来的那天是星期日，怎么办？	关押一个礼拜的朋友是放的日期是星期天，该怎么处理呢？	1	
伪造、变造或者使用伪造、变造的检验够格标明、保险标明的该如何进行处罚	伪造、变造检验合格标志、保险标志的该如何进行处罚	1	
业主是否可以设立业主大会	我们作为也主能够设立业主大会吗	1	
检查人有亲戚关系的，不能同时担人那些职务	检察人员有亲戚关系的，不能同时担任哪一些职务	1	
借贷对利息约定不明的，出借人主张支付利息合法吗	朋友之间借贷没有明确说明利钱，借出一方可以自己定利钱吗？	1	
在刑法中规定小孩自犯罪要坐牢吗	小孩子触犯刑法会被抓去坐牢吗？	1	
公民可继承的其他合法财产囊括哪些	公民遗产继承范围有哪些	1	
涉外离婚后孩子可以改中国籍吗？	在涉外离异的情形下，孩子可以改中国籍吗	1	
户口已注销的如何申办出生公证？	大陆的户口已注销，本人出生公证怎么办理	1	
我想离婚但对方不肯离怎么办?	想里婚 可是对方不肯离而且结婚证还在对方手里怎么办	1	
可以收养生父母无力抚养的子女吗	父母养不起的孩自可以被收养吗	1	
损害别人的利益行为而违反治安管理的，需要承担责任吗？	在治安管理中等，有败坏别人利益的行止，是要担责吗？	1	
农民购买、使用直接用于农业生产的生产资料，是否适用于消费者权益保护法	农民买直接用在农业生产里的生产资了等东西，能适用消费者权益保护法吗	1	
当事人存在“其他违背诚实信用原则的行为”的，另一方能自己办理有关的手续吗	双方有一人有“其他违背诚是信用原则”的行为，那对方可以自行去办理相关的手续吗	1	
什么条件才能使用交通管制	在什么情况下可以是行交通管制？	1	
被侵权人死于的，谁有权主张侵权赔偿	被侵权人死亡，有权主张侵权赔偿的人有哪些	1	
驾驶的机动车车型是否要与驾驶证上载明的准驾车型一致	用C牌着的驾驶证来开B牌照的车允许吗？	1	
对交警作出政出分作出决定前可以停掉它的执行职务吗？	交警被行政处罚，能否在处分决定作出前停掉职务？	1	
盗用别人的美术作品，构成侵权吗？	没有经过我的同意有人是用了我的绘画作品，这属不属于侵权？	1	
员工宿舍内物品被到，可以要求公司赔偿吗？	我的电脑是放在公司的宿舍里面被盗的，能叫公司赔偿么？	1	
公安法一鉴定一般的多长时间出结果	轻微伤法医鉴定结论最长多长时间出结果	1	
客车晚点，可以要其改乘其他班车吗？	由于客车没按规定时刻抵达指定地址，是否可以让他改乘其他班车	1	
领取失业金的申请材料有哪些？	领取是业保险金需要提供哪些材料？	1	
旅客可以在承运人迟延运书的情况下主张什么权利	运输合同承运人迟延运输的，旅客可以主张什么权利	1	
利害关系人申请人民法院宣告婚姻无效夫妻一方死亡的，谁是被申请人	利害关系人申请法院宣告婚姻无学夫妻一方死亡的，被申请人是谁	1	
打牌时欠了朋友钱，这算是赌博的钱吗？用还吗？	我和友人一起打牌，该了友人钱，这个钱算是赌博的钱么，需要还么	1	
请问哪些属于行政公益诉讼案件的范围	谁可以给我说一下行政公益词讼案子的范围都有什么？	1	
罚款超过15天了还没去交，警察会把我查封的房子卖掉吗？	警察有权利在我逾期15天没有提交罚款的情况下把我之前查封的房子卖掉吗？	1	
婚姻期间男方婚内生子是犯法吗	男方婚内出轨有了孩子算作犯罪呢	1	
我委托他人壁我办事务，我需预付费用吗？	委托人委托受托人处理事务是不是应该付费用？	1	
一方有外遇起诉离婚一定会判离吗？	有了婚外情起诉离异，人民法院就一定会判决离异吗	1	
被交通警察扣留机动车驾驶证的犯法行为人应在多长时间内到公安机关交通管理部门接受处理	我的摩托车驾驶证被扣留了，我应当在多少天内到公安机关交通管理部门处理？	1	
企业产品在监都抽查中被判定为不合格怎么办	产品被工商行政管理局抽查不达标的解决办法？	1	
企业经营困难可以协商拖欠工资吗	公司资金遇到问题，可以相商拖欠工资么？	1	
劳务派遣合同到期公司不续签，能要求公司赔偿吗？	我的劳务派遣合同道期了，但是公司不跟我继续签订，我可以要求公司赔偿吗	1	
在酒家被盗，酒家该不该赔我的损失？	酒店有责任赔偿我在酒店物品被盗的损失吗？	1	
担保人拒绝履行担保产生的迟延利息，债务人要还吗？	债务人需要偿还因为但保人拒绝履行担保而产生的迟延利息吗？	1	
一般保证中，主债务诉讼时效中止的，保证债务的诉讼时效是否同时中止	对于一般保证，主债务诉讼时效中止，那么保证债诉讼时效会不会也中止	1	
车辆刮蹭怎么料理？	我的车被剐蹭的解决办法有哪些？	1	
怎样才算家庭暴里？	什么样的情况才算构成家庭暴力	1	
运输合同承运人擅自变更运输工具而增高服务标准的，是否可以加费	在运输过程中，运输合同承运人更换运输工具而提高服务标准，加费合法吗？	1	
购个2手车发现有事 可以退吗	隐瞒二手车出事故,能退车吗	1	
从事哪些食品相关行业应当一法取得许可	在我国想从事哪些食品相关行业必须取得许可的？	1	
倒卖演唱会们票犯法吗？	有人在网上倒卖演唱会门票，这样犯法么？	1	
对于未成年人犯罪原因的预防家庭应怎么做.	家人应该作哪些干活儿来预防未成年孩子犯罪	1	
第一审行政案件为何是基层人民法院审理呢>	简述基层人民法院审理地一审行政案子的原因	1	
试用期内辞职要赔偿培训费用吗？	试用期离职需赔培训费吗	1	
行政出罚程序主要包括哪些内容？	行政处罚一般程序有哪些	1	
如何处理离婚时，一方伪造债务的行为？	离婚诉讼中对方之作假欠条的解决办法	1	
什么是征用，物权法是如何规定的？	物权法对征用的概念是怎么确定的	1	
主合同和担保合同选择管辖的法院不一之的，应当如何确定案件管辖	当出现主合同和担保合同选择管辖的法院不一致的情况时，应该怎么确定案件管辖	1	
对偷窃水电燃气等盗窃数额计算方法是什么	法律是怎么断定偷盗水电煤气的盗窃数额的	1	
应该向哪个法院起诉对限制人身自由的行政强制措施不服的诉讼案件？	我被行政机关强制限量了人身自由，我要强应该去什么法院去起诉他们？	1	
建设用地使用权人是否要支出出让金	建设用地使用权人不支付出让金会违法吗？	1	
小区物管收停车费的资费标准是什么？？	在学区停车，小区物管的收费标准是多少？	1	
雇员在提供劳务进程被第三人弄伤，谁负责赔偿？	打工仔在工作的时候被第三人弄伤,谁承担赔偿责任吗	1	
房主卖房后不迁走户口怎么办？	房屋买卖后，卖主仍不前走户口的咋整？	1	
对拒不执行有关探望子女等判决和裁定的，由人民法院依法强制执行的规定是什么	拒不执行有关探望自女等判决和裁定的，由人民法院依法强制执行是怎么规定的	1	
无线电频谱资源是否属于国家所有	无线电频谱资源不属于过家吗	1	
什么是公一诉讼？	公益诉讼的概念	1	
连带责任保证借款合同中，出借人仅起诉保证人的，人民法院是否可以追加借款人为共同被告	连带责任保证借款合同中等，出借人仅起诉保人的，人民法院可以追加借款人为共同被告吗	1	
出售、非法是供公民个人信息罪怎么处罚？	如何判罚出售、非法提供个人信息的罪行呢？	1	
要求工伤赔偿是否包括搭公交车上下班发生的交通事故	在搭公交车途中与汽车产生相撞并且惨重负伤，是否可以要求工伤赔偿	1	
公安机关对具有哪些情形的犯罪嫌疑人可以立即逮捕	在什么情况下警可以立即拘捕犯罪嫌疑人?	1	
反倾销说的征收一般不能超过几年?	反倾销税征收的时间期限是多久	1	
债权人行使留置权与其承担的义务或者合约的特殊说定相抵触的，人民法院是否支持	我作为债权人的行使留置权和我自己承担的义务或者合同的特殊约定相抵触了，法院还支持我吗？	1	
能根据路上的监控画面对犯法的机动车所有人或者管理人进行处罚吗	交叉路口的监控摄像头记录画面可以作为处罚机动车所有人或者管理人的依据吗	1	
在执行中双方当事人能否自行和解？	双方当事人在执行中有一向自行和解，行吗？	1	
休婚假还有工子吗？婚假的工资怎么计算？	休婚假公司还发工资吗？如何计算婚假工资？	1	
婚姻关系存续期间，夫妻一方可以向人民法院请求分割共同财产的情形有哪些	婚姻关系存续期间，夫妻一方可以向人民法院请求分个共同财产要符合什么情况？	1	
发生交通事故后如何做伤残鉴定？	交通是故伤残鉴定怎么鉴定？	1	
嫌疑人在拘留所呆多久才会被人民法院提审？	警察局从拘留嫌疑犯开始到法院对他提审，期限是多长？	1	
旅客携带行李有什么要求？	运输不门对旅客携带行李有什么要求？	1	
婚后父母赠与的房产，夫妻之间是共同共有吗？	婚后父母赠与的房产是否属于夫只共有财产	1	
没有签订赠与合约，赠与成立吗？	双方没签订赠与合同，赠与可以成立吗？	1	
合同法实施以后，人民法院要确认合约无效的，应以什么法律规定为依据	在合同法付诸实施之后，法院要确认合同属于无效合同的，应该以什么样的法律规定为依据	1	
是否应当进行是品安全风险评估才能判断某一因素是否构成食品安全隐患	我们判断某一因素是否构成食品安全隐患时需不需要进行食品安全风险评估	1	
对方在拘留所，我怎么离婚？	怎么跟在拘留所的老公里婚	1	
用人单位制定的规章制度违反法度、法规确定的，是否应当承担法律责任	用人单位制定的规章制度有违反法律、法规规定的情况，需要承担法律责任吗？	1	
行纪人完成或者部分完成委托是务的，委托人是否应支付报酬	行纪人完成了委托的事务或者完成了一部分的，委托人应该支付报酬吗	1	
行政机关履职在行政公益诉讼中怎么体现?	在行政公益诉讼中，行政机关的履之应该怎么体现呢？	1	
故意伤害罪认定时应注意哪些问题	认定故意伤害罪有哪些问题需注意？	1	
